FIPS,County_State,Population_Density,Total_Population,Population_Urban,Population_Rural,ruralUrban_byPop,ruralUrban
1001,"Autauga, Alabama",94.3,56059,32635,23424,Urban,Rural
1003,"Baldwin, Alabama",141.8,225463,129911,95552,Urban,Rural
1005,"Barbour, Alabama",27.8,24575,7921,16654,Rural,Rural
1007,"Bibb, Alabama",36.0,22427,7072,15355,Rural,Rural
1009,"Blount, Alabama",89.9,57997,5806,52191,Urban,Rural
1011,"Bullock, Alabama",16.2,10096,4898,5198,Rural,Rural
1013,"Butler, Alabama",25.0,19424,5584,13840,Rural,Rural
1015,"Calhoun, Alabama",187.7,113714,75269,38445,Urban,Rural
1017,"Chambers, Alabama",55.8,33275,16919,16356,Rural,Rural
1019,"Cherokee, Alabama",47.6,26346,3756,22590,Rural,Rural
1021,"Chilton, Alabama",64.3,44525,5876,38649,Rural,Rural
1023,"Choctaw, Alabama",13.8,12574,0,12574,Rural,Rural
1025,"Clarke, Alabama",19.0,23592,5678,17914,Rural,Rural
1027,"Clay, Alabama",21.9,13250,0,13250,Rural,Rural
1029,"Cleburne, Alabama",26.7,14941,0,14941,Rural,Rural
1031,"Coffee, Alabama",77.4,52521,27830,24691,Urban,Rural
1033,"Colbert, Alabama",93.4,55354,31060,24294,Urban,Rural
1035,"Conecuh, Alabama",14.2,12050,2301,9749,Rural,Rural
1037,"Coosa, Alabama",16.4,10687,0,10687,Rural,Rural
1039,"Covington, Alabama",36.0,37134,11291,25843,Rural,Rural
1041,"Crenshaw, Alabama",22.7,13798,0,13798,Rural,Rural
1043,"Cullman, Alabama",114.4,84084,22443,61641,Urban,Rural
1045,"Dale, Alabama",87.5,49102,24077,25025,Rural,Rural
1047,"Dallas, Alabama",37.8,36960,20130,16830,Rural,Rural
1049,"Dekalb, Alabama",92.2,71651,7081,64570,Urban,Rural
1051,"Elmore, Alabama",132.0,81661,36870,44791,Urban,Rural
1053,"Escambia, Alabama",38.9,36768,13545,23223,Rural,Rural
1055,"Etowah, Alabama",191.4,102381,64046,38335,Urban,Rural
1057,"Fayette, Alabama",26.0,16311,3214,13097,Rural,Rural
1059,"Franklin, Alabama",49.5,31353,9289,22064,Rural,Rural
1061,"Geneva, Alabama",45.8,26333,2738,23595,Rural,Rural
1063,"Greene, Alabama",12.5,8096,0,8096,Rural,Rural
1065,"Hale, Alabama",22.7,14647,1591,13056,Rural,Rural
1067,"Henry, Alabama",30.8,17283,2117,15166,Rural,Rural
1069,"Houston, Alabama",183.1,106174,70233,35941,Urban,Rural
1071,"Jackson, Alabama",48.0,51745,11900,39845,Urban,Rural
1073,"Jefferson, Alabama",592.9,658926,593970,64956,Urban,Urban
1075,"Lamar, Alabama",22.8,13811,0,13811,Rural,Rural
1077,"Lauderdale, Alabama",139.2,92926,47161,45765,Urban,Rural
1079,"Lawrence, Alabama",47.8,32984,2864,30120,Rural,Rural
1081,"Lee, Alabama",272.2,165375,119550,45825,Urban,Rural
1083,"Limestone, Alabama",178.3,99825,42167,57658,Urban,Rural
1085,"Lowndes, Alabama",13.5,9686,0,9686,Rural,Rural
1087,"Macon, Alabama",29.6,18031,8069,9962,Rural,Rural
1089,"Madison, Alabama",467.8,374983,313094,61889,Urban,Rural
1091,"Marengo, Alabama",19.3,18832,5788,13044,Rural,Rural
1093,"Marion, Alabama",40.1,29782,3295,26487,Rural,Rural
1095,"Marshall, Alabama",171.4,96982,45278,51704,Urban,Rural
1097,"Mobile, Alabama",336.2,413330,330312,83018,Urban,Rural
1099,"Monroe, Alabama",20.2,20697,4355,16342,Rural,Rural
1101,"Montgomery, Alabama",288.1,225904,202240,23664,Urban,Rural
1103,"Morgan, Alabama",206.9,119864,73489,46375,Urban,Rural
1105,"Perry, Alabama",12.4,8905,0,8905,Rural,Rural
1107,"Pickens, Alabama",22.6,19928,0,19928,Rural,Rural
1109,"Pike, Alabama",49.3,33118,16133,16985,Rural,Rural
1111,"Randolph, Alabama",39.2,22779,4234,18545,Rural,Rural
1113,"Russell, Alabama",90.6,58095,37539,20556,Urban,Rural
1115,"St Clair, Alabama",142.4,90004,24437,65567,Urban,Rural
1117,"Shelby, Alabama",278.4,218514,168051,50463,Urban,Rural
1119,"Sumter, Alabama",13.7,12396,0,12396,Rural,Rural
1121,"Talladega, Alabama",108.6,80019,35244,44775,Urban,Rural
1123,"Tallapoosa, Alabama",56.4,40416,10406,30010,Rural,Rural
1125,"Tuscaloosa, Alabama",158.9,210089,155955,54134,Urban,Rural
1127,"Walker, Alabama",80.5,63655,16478,47177,Urban,Rural
1129,"Washington, Alabama",15.1,16314,0,16314,Rural,Rural
1131,"Wilcox, Alabama",11.7,10364,0,10364,Rural,Rural
1133,"Winston, Alabama",38.6,23651,3562,20089,Rural,Rural
2013,"Aleutians East Borough, Alaska",0.5,3335,0,3335,Rural,Rural
2016,"Aleutians West Census Area, Alaska",1.3,5623,0,5623,Rural,Rural
2020,"Anchorage Municipality, Alaska",168.4,287009,275223,11786,Urban,Rural
2050,"Bethel Census Area, Alaska",0.5,18348,4772,13576,Rural,Rural
2060,"Bristol Bay Borough, Alaska",1.6,831,0,831,Rural,Rural
2068,"Denali Borough, Alaska",0.2,2101,0,2101,Rural,Rural
2070,"Dillingham Census Area, Alaska",0.3,4905,0,4905,Rural,Rural
2090,"Fairbanks North Star Borough, Alaska",13.1,96444,66675,29769,Urban,Rural
2100,"Haines Borough, Alaska",1.1,2524,0,2524,Rural,Rural
2105,"Hoonah-Angoon Census Area, Alaska",0.3,2146,0,2146,Rural,Rural
2110,"Juneau City And Borough, Alaska",11.8,31981,25112,6869,Rural,Rural
2122,"Kenai Peninsula Borough, Alaska",3.7,58806,12061,46745,Urban,Rural
2130,"Ketchikan Gateway Borough, Alaska",2.9,13928,10637,3291,Rural,Rural
2150,"Kodiak Island Borough, Alaska",2.0,12896,8910,3986,Rural,Rural
2158,"Kusilvak Census Area, Alaska",0.5,8280,0,8280,Rural,Rural
2164,"Lake And Peninsula Borough, Alaska",0.1,1581,0,1581,Rural,Rural
2170,"Matanuska-Susitna Borough, Alaska",4.4,108894,54325,54569,Urban,Rural
2180,"Nome Census Area, Alaska",0.4,9945,3402,6543,Rural,Rural
2185,"North Slope Borough, Alaska",0.1,9821,4085,5736,Rural,Rural
2188,"Northwest Arctic Borough, Alaska",0.2,7564,3216,4348,Rural,Rural
2195,"Petersburg Census Area, Alaska",1.0,3258,0,3258,Rural,Rural
2198,"Prince Of Wales-Hyder Census Area, Alaska",1.6,6186,0,6186,Rural,Rural
2220,"Sitka City And Borough, Alaska",3.0,8497,6726,1771,Rural,Rural
2230,"Skagway Municipality, Alaska",2.6,1182,0,1182,Rural,Rural
2240,"Southeast Fairbanks Census Area, Alaska",0.3,6867,0,6867,Rural,Rural
2261,"Valdez-Cordova Census Area, Alaska",0.3,9196,0,9196,Rural,Rural
2275,"Wrangell City And Borough, Alaska",1.0,2491,0,2491,Rural,Rural
2282,"Yakutat City And Borough, Alaska",0.1,577,0,577,Rural,Rural
2290,"Yukon-Koyukuk Census Area, Alaska",0.0,5195,0,5195,Rural,Rural
4001,"Apache, Arizona",6.4,72068,18632,53436,Urban,Rural
4003,"Cochise, Arizona",20.4,125866,79990,45876,Urban,Rural
4005,"Coconino, Arizona",7.8,144552,99879,44673,Urban,Rural
4007,"Gila, Arizona",11.4,54198,31906,22292,Urban,Rural
4009,"Graham, Arizona",8.4,39011,21287,17724,Rural,Rural
4011,"Greenlee, Arizona",5.2,9493,5070,4423,Rural,Rural
4012,"La Paz, Arizona",4.7,21195,9253,11942,Rural,Rural
4013,"Maricopa, Arizona",490.5,4512331,4403475,108856,Urban,Rural
4015,"Mohave, Arizona",16.1,213678,163689,49989,Urban,Rural
4017,"Navajo, Arizona",11.2,111160,51076,60084,Urban,Rural
4019,"Pima, Arizona",114.6,1052466,972910,79556,Urban,Rural
4021,"Pinal, Arizona",87.1,467550,367787,99763,Urban,Rural
4023,"Santa Cruz, Arizona",37.6,46451,33928,12523,Rural,Rural
4025,"Yavapai, Arizona",29.2,237378,158157,79221,Urban,Rural
4027,"Yuma, Arizona",38.8,214121,190510,23611,Urban,Rural
5001,"Arkansas, Arkansas",17.7,17468,11425,6043,Rural,Rural
5003,"Ashley, Arkansas",21.2,19602,9488,10114,Rural,Rural
5005,"Baxter, Arkansas",76.2,42212,14432,27780,Rural,Rural
5007,"Benton, Arkansas",331.7,281073,210029,71044,Urban,Rural
5009,"Boone, Arkansas",63.6,37552,14188,23364,Rural,Rural
5011,"Bradley, Arkansas",16.6,10800,5419,5381,Rural,Rural
5013,"Calhoun, Arkansas",8.3,5221,0,5221,Rural,Rural
5015,"Carroll, Arkansas",45.2,28510,7738,20772,Rural,Rural
5017,"Chicot, Arkansas",15.6,10063,4612,5451,Rural,Rural
5019,"Clark, Arkansas",25.7,22280,10398,11882,Rural,Rural
5021,"Clay, Arkansas",22.8,14558,5958,8600,Rural,Rural
5023,"Cleburne, Arkansas",45.1,24967,6099,18868,Rural,Rural
5025,"Cleveland, Arkansas",13.3,7949,0,7949,Rural,Rural
5027,"Columbia, Arkansas",30.6,23424,10221,13203,Rural,Rural
5029,"Conway, Arkansas",37.9,20908,6199,14709,Rural,Rural
5031,"Craighead, Arkansas",156.8,110860,75082,35778,Urban,Rural
5033,"Crawford, Arkansas",107.0,63436,30483,32953,Urban,Rural
5035,"Crittenden, Arkansas",78.5,47837,37914,9923,Rural,Rural
5037,"Cross, Arkansas",26.6,16401,7089,9312,Rural,Rural
5039,"Dallas, Arkansas",10.5,6995,3345,3650,Rural,Rural
5041,"Desha, Arkansas",14.7,11324,7773,3551,Rural,Rural
5043,"Drew, Arkansas",22.0,18244,9364,8880,Rural,Rural
5045,"Faulkner, Arkansas",195.0,126340,77283,49057,Urban,Rural
5047,"Franklin, Arkansas",29.2,17763,3063,14700,Rural,Rural
5049,"Fulton, Arkansas",20.3,12550,868,11682,Rural,Rural
5051,"Garland, Arkansas",147.5,99945,62944,37001,Urban,Rural
5053,"Grant, Arkansas",29.0,18332,4584,13748,Rural,Rural
5055,"Greene, Arkansas",78.7,45465,26673,18792,Rural,Rural
5057,"Hempstead, Arkansas",29.6,21504,9477,12027,Rural,Rural
5059,"Hot Spring, Arkansas",55.1,33867,11652,22215,Rural,Rural
5061,"Howard, Arkansas",22.5,13225,4261,8964,Rural,Rural
5063,"Independence, Arkansas",49.6,37914,11951,25963,Rural,Rural
5065,"Izard, Arkansas",23.6,13679,0,13679,Rural,Rural
5067,"Jackson, Arkansas",26.4,16722,5714,11008,Rural,Rural
5069,"Jefferson, Arkansas",76.4,66485,45922,20563,Urban,Rural
5071,"Johnson, Arkansas",40.4,26672,7686,18986,Rural,Rural
5073,"Lafayette, Arkansas",12.5,6612,0,6612,Rural,Rural
5075,"Lawrence, Arkansas",27.9,16415,5986,10429,Rural,Rural
5077,"Lee, Arkansas",14.7,8831,3141,5690,Rural,Rural
5079,"Lincoln, Arkansas",23.3,13081,0,13081,Rural,Rural
5081,"Little River, Arkansas",23.1,12275,3854,8421,Rural,Rural
5083,"Logan, Arkansas",30.4,21501,6227,15274,Rural,Rural
5085,"Lonoke, Arkansas",95.6,73667,40619,33048,Urban,Rural
5087,"Madison, Arkansas",20.0,16674,0,16674,Rural,Rural
5089,"Marion, Arkansas",28.2,16821,0,16821,Rural,Rural
5091,"Miller, Arkansas",69.3,43325,25965,17360,Rural,Rural
5093,"Mississippi, Arkansas",44.9,40449,25745,14704,Rural,Rural
5095,"Monroe, Arkansas",11.0,6680,2069,4611,Rural,Rural
5097,"Montgomery, Arkansas",11.6,9025,0,9025,Rural,Rural
5099,"Nevada, Arkansas",13.4,8258,2525,5733,Rural,Rural
5101,"Newton, Arkansas",9.5,7771,0,7771,Rural,Rural
5103,"Ouachita, Arkansas",31.9,23384,10215,13169,Rural,Rural
5105,"Perry, Arkansas",19.0,10478,0,10478,Rural,Rural
5107,"Phillips, Arkansas",25.4,17639,9180,8459,Rural,Rural
5109,"Pike, Arkansas",17.9,10736,0,10736,Rural,Rural
5111,"Poinsett, Arkansas",31.0,23537,6779,16758,Rural,Rural
5113,"Polk, Arkansas",23.3,20000,5322,14678,Rural,Rural
5115,"Pope, Arkansas",79.2,64342,29121,35221,Urban,Rural
5117,"Prairie, Arkansas",12.4,8057,0,8057,Rural,Rural
5119,"Pulaski, Arkansas",516.2,392189,343823,48366,Urban,Urban
5121,"Randolph, Arkansas",27.7,18036,5882,12154,Rural,Rural
5123,"St Francis, Arkansas",39.1,24832,12293,12539,Rural,Rural
5125,"Saline, Arkansas",170.4,123287,78647,44640,Urban,Rural
5127,"Scott, Arkansas",11.5,10284,3023,7261,Rural,Rural
5129,"Searcy, Arkansas",11.9,7903,0,7903,Rural,Rural
5131,"Sebastian, Arkansas",240.7,128014,101137,26877,Urban,Rural
5133,"Sevier, Arkansas",30.1,17018,6171,10847,Rural,Rural
5135,"Sharp, Arkansas",29.1,17579,3475,14104,Rural,Rural
5137,"Stone, Arkansas",20.7,12555,0,12555,Rural,Rural
5139,"Union, Arkansas",37.2,38617,17620,20997,Rural,Rural
5141,"Van Buren, Arkansas",23.4,16571,0,16571,Rural,Rural
5143,"Washington, Arkansas",254.9,240117,178700,61417,Urban,Rural
5145,"White, Arkansas",76.3,79013,36050,42963,Urban,Rural
5147,"Woodruff, Arkansas",10.7,6307,0,6307,Rural,Rural
5149,"Yell, Arkansas",23.0,21367,4469,16898,Rural,Rural
6001,"Alameda, California",2261.3,1671168,1664624,6544,Urban,Urban
6003,"Alpine, California",1.5,1136,0,1136,Rural,Rural
6005,"Amador, California",67.5,40131,15741,24390,Rural,Rural
6007,"Butte, California",133.9,219114,177823,41291,Urban,Rural
6009,"Calaveras, California",45.1,46038,11273,34765,Rural,Rural
6011,"Colusa, California",18.8,21605,14717,6888,Rural,Rural
6013,"Contra Costa, California",1613.5,1155188,1145964,9224,Urban,Urban
6015,"Del Norte, California",27.8,27972,18450,9522,Rural,Rural
6017,"El Dorado, California",113.5,193913,126649,67264,Urban,Rural
6019,"Fresno, California",168.1,1001679,893741,107938,Urban,Rural
6021,"Glenn, California",21.7,28526,16875,11651,Rural,Rural
6023,"Humboldt, California",38.1,135819,95630,40189,Urban,Rural
6025,"Imperial, California",43.3,180991,151053,29938,Urban,Rural
6027,"Inyo, California",1.8,18076,9672,8404,Rural,Rural
6029,"Kern, California",111.1,903079,812484,90595,Urban,Rural
6031,"Kings, California",110.5,153468,136200,17268,Urban,Rural
6033,"Lake, California",51.4,64614,43312,21302,Urban,Rural
6035,"Lassen, California",6.7,30568,9353,21215,Rural,Rural
6037,"Los Angeles, California",2474.4,10040723,9979917,60806,Urban,Urban
6039,"Madera, California",73.9,157915,106835,51080,Urban,Rural
6041,"Marin, California",497.8,259027,242075,16952,Urban,Rural
6043,"Mariposa, California",11.9,17246,0,17246,Rural,Rural
6045,"Mendocino, California",24.8,86919,47681,39238,Urban,Rural
6047,"Merced, California",144.3,279313,239132,40181,Urban,Rural
6049,"Modoc, California",2.3,8840,2681,6159,Rural,Rural
6051,"Mono, California",4.7,14362,7864,6498,Rural,Rural
6053,"Monterey, California",132.5,434621,391808,42813,Urban,Rural
6055,"Napa, California",184.4,137969,119440,18529,Urban,Rural
6057,"Nevada, California",104.6,100191,57910,42281,Urban,Rural
6059,"Orange, California",4019.8,3177905,3173369,4536,Urban,Urban
6061,"Placer, California",285.3,401405,345975,55430,Urban,Rural
6063,"Plumas, California",7.4,18885,4903,13982,Rural,Rural
6065,"Riverside, California",344.7,2483726,2370320,113406,Urban,Rural
6067,"Sacramento, California",1613.9,1556817,1524643,32174,Urban,Urban
6069,"San Benito, California",45.6,63266,48149,15117,Urban,Rural
6071,"San Bernardino, California",109.0,2185317,2081488,103829,Urban,Rural
6073,"San Diego, California",795.1,3344694,3234078,110616,Urban,Urban
6075,"San Francisco, California",18825.8,882417,882417,0,Urban,Urban
6077,"San Joaquin, California",550.2,765512,700551,64961,Urban,Urban
6079,"San Luis Obispo, California",86.1,284085,236559,47526,Urban,Rural
6081,"San Mateo, California",1707.9,765837,751245,14592,Urban,Urban
6083,"Santa Barbara, California",163.6,447530,425060,22470,Urban,Rural
6085,"Santa Clara, California",1491.6,1924317,1903383,20934,Urban,Urban
6087,"Santa Cruz, California",614.4,273524,240733,32791,Urban,Urban
6089,"Shasta, California",47.9,180772,127788,52984,Urban,Rural
6091,"Sierra, California",3.2,3009,8,3001,Rural,Rural
6093,"Siskiyou, California",7.0,43732,14994,28738,Rural,Rural
6095,"Solano, California",546.5,449107,432198,16909,Urban,Urban
6097,"Sonoma, California",313.8,494527,433453,61074,Urban,Rural
6099,"Stanislaus, California",369.7,552693,508634,44059,Urban,Rural
6101,"Sutter, California",161.5,97287,82841,14446,Urban,Rural
6103,"Tehama, California",22.1,65316,31718,33598,Urban,Rural
6105,"Trinity, California",3.8,12236,0,12236,Rural,Rural
6107,"Tulare, California",96.8,466926,394723,72203,Urban,Rural
6109,"Tuolumne, California",24.7,54761,28249,26512,Urban,Rural
6111,"Ventura, California",459.6,847146,820777,26369,Urban,Rural
6113,"Yolo, California",218.0,221203,206014,15189,Urban,Rural
6115,"Yuba, California",125.3,79182,58453,20729,Urban,Rural
8001,"Adams, Colorado",444.8,519315,500051,19264,Urban,Rural
8003,"Alamosa, Colorado",22.7,16423,10415,6008,Rural,Rural
8005,"Arapahoe, Colorado",824.0,657609,647256,10353,Urban,Urban
8007,"Archuleta, Colorado",10.5,14179,5792,8387,Rural,Rural
8009,"Baca, Colorado",1.4,3594,0,3594,Rural,Rural
8011,"Bent, Colorado",3.7,5548,3397,2151,Rural,Rural
8013,"Boulder, Colorado",450.8,327381,298097,29284,Urban,Rural
8014,"Broomfield, Colorado",2143.6,70811,70393,418,Urban,Urban
8015,"Chaffee, Colorado",20.2,20513,12761,7752,Rural,Rural
8017,"Cheyenne, Colorado",1.0,1833,0,1833,Rural,Rural
8019,"Clear Creek, Colorado",24.6,9734,0,9734,Rural,Rural
8021,"Conejos, Colorado",6.4,8240,0,8240,Rural,Rural
8023,"Costilla, Colorado",3.2,3918,0,3918,Rural,Rural
8025,"Crowley, Colorado",7.8,6156,0,6156,Rural,Rural
8027,"Custer, Colorado",6.9,5127,0,5127,Rural,Rural
8029,"Delta, Colorado",27.5,31373,11507,19866,Rural,Rural
8031,"Denver, Colorado",4767.0,729348,729348,0,Urban,Urban
8033,"Dolores, Colorado",1.9,2067,0,2067,Rural,Rural
8035,"Douglas, Colorado",420.5,353316,316641,36675,Urban,Rural
8037,"Eagle, Colorado",32.8,55196,44126,11070,Urban,Rural
8039,"Elbert, Colorado",14.5,26896,0,26896,Rural,Rural
8041,"El Paso, Colorado",340.8,724738,659484,65254,Urban,Rural
8043,"Fremont, Colorado",31.3,48031,35085,12946,Rural,Rural
8045,"Garfield, Colorado",20.4,60213,45673,14540,Urban,Rural
8047,"Gilpin, Colorado",42.0,6293,0,6293,Rural,Rural
8049,"Grand, Colorado",8.5,15783,2835,12948,Rural,Rural
8051,"Gunnison, Colorado",5.4,17600,7310,10290,Rural,Rural
8053,"Hinsdale, Colorado",0.7,828,0,828,Rural,Rural
8055,"Huerfano, Colorado",4.4,6969,3046,3923,Rural,Rural
8057,"Jackson, Colorado",0.9,1397,0,1397,Rural,Rural
8059,"Jefferson, Colorado",765.1,584699,544082,40617,Urban,Urban
8061,"Kiowa, Colorado",0.8,1414,0,1414,Rural,Rural
8063,"Kit Carson, Colorado",3.3,7078,3432,3646,Rural,Rural
8065,"Lake, Colorado",21.7,8165,5626,2539,Rural,Rural
8067,"La Plata, Colorado",33.4,56432,22581,33851,Urban,Rural
8069,"Larimer, Colorado",138.4,359303,317333,41970,Urban,Rural
8071,"Las Animas, Colorado",3.1,14578,8609,5969,Rural,Rural
8073,"Lincoln, Colorado",2.2,5742,0,5742,Rural,Rural
8075,"Logan, Colorado",12.1,22227,15733,6494,Rural,Rural
8077,"Mesa, Colorado",46.6,155037,135387,19650,Urban,Rural
8079,"Mineral, Colorado",0.9,775,0,775,Rural,Rural
8081,"Moffat, Colorado",2.8,13290,9644,3646,Rural,Rural
8083,"Montezuma, Colorado",13.0,26288,8583,17705,Rural,Rural
8085,"Montrose, Colorado",19.2,43000,23625,19375,Rural,Rural
8087,"Morgan, Colorado",22.7,29042,19514,9528,Rural,Rural
8089,"Otero, Colorado",14.5,18335,12079,6256,Rural,Rural
8091,"Ouray, Colorado",9.2,4987,0,4987,Rural,Rural
8093,"Park, Colorado",8.7,19031,0,19031,Rural,Rural
8095,"Phillips, Colorado",6.2,4264,0,4264,Rural,Rural
8097,"Pitkin, Colorado",18.2,17683,9861,7822,Rural,Rural
8099,"Prowers, Colorado",7.4,12206,7603,4603,Rural,Rural
8101,"Pueblo, Colorado",70.9,169155,144987,24168,Urban,Rural
8103,"Rio Blanco, Colorado",2.0,6321,0,6321,Rural,Rural
8105,"Rio Grande, Colorado",12.4,11268,4216,7052,Rural,Rural
8107,"Routt, Colorado",10.9,25796,14146,11650,Rural,Rural
8109,"Saguache, Colorado",2.2,6858,0,6858,Rural,Rural
8111,"San Juan, Colorado",1.9,733,0,733,Rural,Rural
8113,"San Miguel, Colorado",6.4,8187,0,8187,Rural,Rural
8115,"Sedgwick, Colorado",4.1,2255,0,2255,Rural,Rural
8117,"Summit, Colorado",51.1,31083,25037,6046,Rural,Rural
8119,"Teller, Colorado",45.9,25563,9495,16068,Rural,Rural
8121,"Washington, Colorado",2.0,4932,0,4932,Rural,Rural
8123,"Weld, Colorado",82.0,327077,259708,67369,Urban,Rural
8125,"Yuma, Colorado",4.2,10035,3528,6507,Rural,Rural
9001,"Fairfield, Connecticut",1508.4,942596,899520,43076,Urban,Urban
9003,"Hartford, Connecticut",1212.9,891590,843360,48230,Urban,Urban
9005,"Litchfield, Connecticut",196.0,180429,106003,74426,Urban,Rural
9007,"Middlesex, Connecticut",440.3,162611,122715,39896,Urban,Rural
9009,"New Haven, Connecticut",1414.2,854873,823621,31252,Urban,Urban
9011,"New London, Connecticut",399.1,265342,196639,68703,Urban,Rural
9013,"Tolland, Connecticut",367.8,150866,92733,58133,Urban,Rural
9015,"Windham, Connecticut",228.1,116984,58732,58252,Urban,Rural
10001,"Kent, Delaware",310.1,181760,132863,48897,Urban,Rural
10003,"New Castle, Delaware",1315.2,560636,534717,25919,Urban,Urban
10005,"Sussex, Delaware",252.5,236403,138304,98099,Urban,Rural
11001,"District Of Columbia, District Of Columbia",11564.4,705989,705989,0,Urban,Urban
12001,"Alachua, Florida",308.6,270032,212396,57636,Urban,Rural
12003,"Baker, Florida",50.3,29434,11813,17621,Rural,Rural
12005,"Bay, Florida",228.7,173469,152406,21063,Urban,Rural
12007,"Bradford, Florida",97.2,28568,7055,21513,Rural,Rural
12009,"Brevard, Florida",597.7,607014,575825,31189,Urban,Urban
12011,"Broward, Florida",1616.2,1955251,1954922,329,Urban,Urban
12013,"Calhoun, Florida",24.8,14062,4502,9560,Rural,Rural
12015,"Charlotte, Florida",280.9,191064,174245,16819,Urban,Rural
12017,"Citrus, Florida",260.2,151369,99119,52250,Urban,Rural
12019,"Clay, Florida",365.3,220763,187580,33183,Urban,Rural
12021,"Collier, Florida",194.1,387966,354607,33359,Urban,Rural
12023,"Columbia, Florida",90.5,72154,27716,44438,Urban,Rural
12027,"Desoto, Florida",59.8,38079,20663,17416,Rural,Rural
12029,"Dixie, Florida",24.0,16919,4039,12880,Rural,Rural
12031,"Duval, Florida",1261.9,961793,933504,28289,Urban,Urban
12033,"Escambia, Florida",487.1,319784,292910,26874,Urban,Rural
12035,"Flagler, Florida",239.8,116416,104366,12050,Urban,Rural
12037,"Franklin, Florida",23.0,12286,3969,8317,Rural,Rural
12039,"Gadsden, Florida",88.4,45669,16230,29439,Rural,Rural
12041,"Gilchrist, Florida",53.5,18716,3028,15688,Rural,Rural
12043,"Glades, Florida",17.3,13948,4033,9915,Rural,Rural
12045,"Gulf, Florida",25.7,14474,3940,10534,Rural,Rural
12047,"Hamilton, Florida",28.1,14449,5092,9357,Rural,Rural
12049,"Hardee, Florida",42.2,26938,14181,12757,Rural,Rural
12051,"Hendry, Florida",36.5,42033,26590,15443,Rural,Rural
12053,"Hernando, Florida",414.9,196043,157844,38199,Urban,Rural
12055,"Highlands, Florida",105.3,107017,84448,22569,Urban,Rural
12057,"Hillsborough, Florida",1444.2,1473380,1421509,51871,Urban,Urban
12059,"Holmes, Florida",41.2,19703,4173,15530,Rural,Rural
12061,"Indian River, Florida",321.2,161546,153617,7929,Urban,Rural
12063,"Jackson, Florida",51.3,47080,11241,35839,Rural,Rural
12065,"Jefferson, Florida",23.9,14288,0,14288,Rural,Rural
12067,"Lafayette, Florida",15.3,8315,0,8315,Rural,Rural
12069,"Lake, Florida",396.2,371792,300093,71699,Urban,Rural
12071,"Lee, Florida",990.9,777411,731954,45457,Urban,Urban
12073,"Leon, Florida",441.5,294412,257969,36443,Urban,Rural
12075,"Levy, Florida",37.4,41797,3273,38524,Rural,Rural
12077,"Liberty, Florida",10.0,8393,0,8393,Rural,Rural
12079,"Madison, Florida",26.6,18524,3714,14810,Rural,Rural
12081,"Manatee, Florida",548.6,407576,383905,23671,Urban,Urban
12083,"Marion, Florida",233.0,369231,254857,114374,Urban,Rural
12085,"Martin, Florida",298.1,161980,148342,13638,Urban,Rural
12086,"Miami-Dade, Florida",1434.0,2721256,2710148,11108,Urban,Urban
12087,"Monroe, Florida",75.4,74150,67714,6436,Urban,Rural
12089,"Nassau, Florida",138.4,89773,46431,43342,Urban,Rural
12091,"Okaloosa, Florida",228.0,212140,186355,25785,Urban,Rural
12093,"Okeechobee, Florida",55.0,42326,26672,15654,Rural,Rural
12095,"Orange, Florida",1546.1,1396795,1367751,29044,Urban,Urban
12097,"Osceola, Florida",285.1,378454,348619,29835,Urban,Rural
12099,"Palm Beach, Florida",762.5,1502034,1486205,15829,Urban,Urban
12101,"Pasco, Florida",750.4,560435,507361,53074,Urban,Urban
12103,"Pinellas, Florida",3579.0,979919,977123,2796,Urban,Urban
12105,"Polk, Florida",407.4,732435,633374,99061,Urban,Rural
12107,"Putnam, Florida",103.0,74925,32700,42225,Urban,Rural
12109,"St Johns, Florida",447.7,268905,204302,64603,Urban,Rural
12111,"St Lucie, Florida",580.5,331983,320940,11043,Urban,Urban
12113,"Santa Rosa, Florida",184.2,186294,147109,39185,Urban,Rural
12115,"Sarasota, Florida",787.8,437909,418650,19259,Urban,Urban
12117,"Seminole, Florida",1531.4,473544,458405,15139,Urban,Urban
12119,"Sumter, Florida",246.1,134623,90600,44023,Urban,Rural
12121,"Suwannee, Florida",64.7,44525,7529,36996,Rural,Rural
12123,"Taylor, Florida",20.7,21546,6823,14723,Rural,Rural
12125,"Union, Florida",61.6,14998,4939,10059,Rural,Rural
12127,"Volusia, Florida",507.1,558323,502497,55826,Urban,Urban
12129,"Wakulla, Florida",56.4,34178,12829,21349,Rural,Rural
12131,"Walton, Florida",72.7,75397,27742,47655,Urban,Rural
12133,"Washington, Florida",44.1,25722,3991,21731,Rural,Rural
13001,"Appling, Georgia",36.3,18413,5253,13160,Rural,Rural
13003,"Atkinson, Georgia",24.1,8182,0,8182,Rural,Rural
13005,"Bacon, Georgia",43.2,11177,3412,7765,Rural,Rural
13007,"Baker, Georgia",8.8,3025,0,3025,Rural,Rural
13009,"Baldwin, Georgia",174.5,44986,29311,15675,Rural,Rural
13011,"Banks, Georgia",83.4,19354,1195,18159,Rural,Rural
13013,"Barrow, Georgia",523.8,83976,58648,25328,Urban,Urban
13015,"Bartow, Georgia",235.7,108306,70071,38235,Urban,Rural
13017,"Ben Hill, Georgia",66.6,16651,11002,5649,Rural,Rural
13019,"Berrien, Georgia",43.1,19478,4658,14820,Rural,Rural
13021,"Bibb, Georgia",614.6,153494,131341,22153,Urban,Urban
13023,"Bleckley, Georgia",59.9,12938,6298,6640,Rural,Rural
13025,"Brantley, Georgia",43.3,19171,103,19068,Rural,Rural
13027,"Brooks, Georgia",31.1,15354,4424,10930,Rural,Rural
13029,"Bryan, Georgia",91.9,40081,18968,21113,Rural,Rural
13031,"Bulloch, Georgia",119.7,80548,41902,38646,Urban,Rural
13033,"Burke, Georgia",27.1,22380,5606,16774,Rural,Rural
13035,"Butts, Georgia",136.7,25209,5520,19689,Rural,Rural
13037,"Calhoun, Georgia",22.0,6180,0,6180,Rural,Rural
13039,"Camden, Georgia",89.6,54907,37740,17167,Urban,Rural
13043,"Candler, Georgia",44.6,10840,3565,7275,Rural,Rural
13045,"Carroll, Georgia",241.7,120634,70244,50390,Urban,Rural
13047,"Catoosa, Georgia",418.8,67906,48744,19162,Urban,Rural
13049,"Charlton, Georgia",17.5,13529,6686,6843,Rural,Rural
13051,"Chatham, Georgia",679.3,289676,276668,13008,Urban,Urban
13053,"Chattahoochee, Georgia",44.1,10969,7451,3518,Rural,Rural
13055,"Chattooga, Georgia",79.2,24828,10220,14608,Rural,Rural
13057,"Cherokee, Georgia",618.4,260752,215853,44899,Urban,Urban
13059,"Clarke, Georgia",1079.3,128658,121128,7530,Urban,Urban
13061,"Clay, Georgia",14.5,2828,0,2828,Rural,Rural
13063,"Clayton, Georgia",2074.8,293733,291073,2660,Urban,Urban
13065,"Clinch, Georgia",8.3,6631,2612,4019,Rural,Rural
13067,"Cobb, Georgia",2242.5,761438,759538,1900,Urban,Urban
13069,"Coffee, Georgia",75.5,43422,14380,29042,Rural,Rural
13071,"Colquitt, Georgia",84.2,45819,18825,26994,Rural,Rural
13073,"Columbia, Georgia",543.8,157742,131947,25795,Urban,Urban
13075,"Cook, Georgia",76.2,17306,7017,10289,Rural,Rural
13077,"Coweta, Georgia",338.8,149354,100299,49055,Urban,Rural
13079,"Crawford, Georgia",38.3,12449,0,12449,Rural,Rural
13081,"Crisp, Georgia",82.0,22355,11810,10545,Rural,Rural
13083,"Dade, Georgia",92.8,16147,4477,11670,Rural,Rural
13085,"Dawson, Georgia",125.3,26411,5273,21138,Rural,Rural
13087,"Decatur, Georgia",44.2,26412,11456,14956,Rural,Rural
13089,"Dekalb, Georgia",2837.4,759228,757198,2030,Urban,Urban
13091,"Dodge, Georgia",41.5,20571,5750,14821,Rural,Rural
13093,"Dooly, Georgia",34.1,13370,6228,7142,Rural,Rural
13095,"Dougherty, Georgia",269.8,88673,76288,12385,Urban,Rural
13097,"Douglas, Georgia",735.1,147078,123878,23200,Urban,Urban
13099,"Early, Georgia",19.9,10176,3468,6708,Rural,Rural
13101,"Echols, Georgia",9.7,4014,0,4014,Rural,Rural
13103,"Effingham, Georgia",136.0,64955,21338,43617,Urban,Rural
13105,"Elbert, Georgia",54.8,19251,5652,13599,Rural,Rural
13107,"Emanuel, Georgia",33.4,22756,7444,15312,Rural,Rural
13109,"Evans, Georgia",58.4,10671,4145,6526,Rural,Rural
13111,"Fannin, Georgia",68.3,26404,0,26404,Rural,Rural
13113,"Fayette, Georgia",591.7,114984,94080,20904,Urban,Urban
13115,"Floyd, Georgia",193.6,98711,62380,36331,Urban,Rural
13117,"Forsyth, Georgia",1100.8,246592,221947,24645,Urban,Urban
13119,"Franklin, Georgia",89.7,23468,2655,20813,Rural,Rural
13121,"Fulton, Georgia",2026.3,1067116,1055513,11603,Urban,Urban
13123,"Gilmer, Georgia",74.1,31594,3888,27706,Rural,Rural
13125,"Glascock, Georgia",20.7,2979,0,2979,Rural,Rural
13127,"Glynn, Georgia",204.1,85660,67835,17825,Urban,Rural
13129,"Gordon, Georgia",163.5,58167,28082,30085,Urban,Rural
13131,"Grady, Georgia",54.2,24623,9251,15372,Rural,Rural
13133,"Greene, Georgia",47.7,18499,3176,15323,Rural,Rural
13135,"Gwinnett, Georgia",2181.8,938995,934396,4599,Urban,Urban
13137,"Habersham, Georgia",164.1,45414,18636,26778,Rural,Rural
13139,"Hall, Georgia",523.3,205525,163192,42333,Urban,Urban
13141,"Hancock, Georgia",18.0,8475,3228,5247,Rural,Rural
13143,"Haralson, Georgia",106.2,29955,6813,23142,Rural,Rural
13145,"Harris, Georgia",76.5,35486,1163,34323,Rural,Rural
13147,"Hart, Georgia",113.4,26360,6757,19603,Rural,Rural
13149,"Heard, Georgia",40.5,11988,0,11988,Rural,Rural
13151,"Henry, Georgia",734.3,236549,203615,32934,Urban,Urban
13153,"Houston, Georgia",422.7,158726,142914,15812,Urban,Rural
13155,"Irwin, Georgia",26.8,9500,3432,6068,Rural,Rural
13157,"Jackson, Georgia",217.5,73881,29501,44380,Urban,Rural
13159,"Jasper, Georgia",38.8,14302,2569,11733,Rural,Rural
13161,"Jeff Davis, Georgia",45.7,15125,4620,10505,Rural,Rural
13163,"Jefferson, Georgia",29.2,15385,2999,12386,Rural,Rural
13165,"Jenkins, Georgia",24.9,8646,3303,5343,Rural,Rural
13167,"Johnson, Georgia",31.8,9643,3332,6311,Rural,Rural
13169,"Jones, Georgia",73.2,28837,9342,19495,Rural,Rural
13171,"Lamar, Georgia",104.6,19190,7273,11917,Rural,Rural
13173,"Lanier, Georgia",56.3,10437,2992,7445,Rural,Rural
13175,"Laurens, Georgia",59.1,47683,20730,26953,Rural,Rural
13177,"Lee, Georgia",84.6,30110,19131,10979,Rural,Rural
13179,"Liberty, Georgia",125.5,61455,46890,14565,Urban,Rural
13181,"Lincoln, Georgia",37.8,7950,0,7950,Rural,Rural
13183,"Long, Georgia",49.1,19662,3660,16002,Rural,Rural
13185,"Lowndes, Georgia",237.3,117727,85382,32345,Urban,Rural
13187,"Lumpkin, Georgia",120.1,33986,5842,28144,Rural,Rural
13189,"Mcduffie, Georgia",82.8,21323,8299,13024,Rural,Rural
13191,"Mcintosh, Georgia",34.1,14450,3693,10757,Rural,Rural
13193,"Macon, Georgia",32.2,12909,6089,6820,Rural,Rural
13195,"Madison, Georgia",106.4,30038,2466,27572,Rural,Rural
13197,"Marion, Georgia",22.9,8365,0,8365,Rural,Rural
13199,"Meriwether, Georgia",42.3,21224,3512,17712,Rural,Rural
13201,"Miller, Georgia",20.2,5715,0,5715,Rural,Rural
13205,"Mitchell, Georgia",42.6,21822,9956,11866,Rural,Rural
13207,"Monroe, Georgia",70.1,27741,5389,22352,Rural,Rural
13209,"Montgomery, Georgia",38.5,9220,118,9102,Rural,Rural
13211,"Morgan, Georgia",56.0,19443,4798,14645,Rural,Rural
13213,"Murray, Georgia",116.7,40213,12067,28146,Rural,Rural
13215,"Muscogee, Georgia",906.1,196062,190229,5833,Urban,Urban
13217,"Newton, Georgia",413.2,112454,77431,35023,Urban,Rural
13219,"Oconee, Georgia",220.3,40604,20192,20412,Rural,Rural
13221,"Oglethorpe, Georgia",35.0,15350,115,15235,Rural,Rural
13223,"Paulding, Georgia",545.2,170215,135970,34245,Urban,Urban
13225,"Peach, Georgia",184.2,27676,17008,10668,Rural,Rural
13227,"Pickens, Georgia",141.5,32843,8847,23996,Rural,Rural
13229,"Pierce, Georgia",61.8,19569,4004,15565,Rural,Rural
13231,"Pike, Georgia",88.5,19118,201,18917,Rural,Rural
13233,"Polk, Georgia",137.7,42733,20758,21975,Rural,Rural
13235,"Pulaski, Georgia",44.8,11161,3676,7485,Rural,Rural
13237,"Putnam, Georgia",64.5,22216,4220,17996,Rural,Rural
13239,"Quitman, Georgia",15.3,2307,622,1685,Rural,Rural
13241,"Rabun, Georgia",46.7,17280,3570,13710,Rural,Rural
13243,"Randolph, Georgia",15.8,6779,3366,3413,Rural,Rural
13245,"Richmond, Georgia",626.1,203065,184131,18934,Urban,Urban
13247,"Rockdale, Georgia",703.1,91261,77724,13537,Urban,Urban
13249,"Schley, Georgia",31.5,5259,0,5259,Rural,Rural
13251,"Screven, Georgia",21.7,13982,2950,11032,Rural,Rural
13253,"Seminole, Georgia",34.3,8080,2524,5556,Rural,Rural
13255,"Spalding, Georgia",341.2,67028,39027,28001,Urban,Rural
13257,"Stephens, Georgia",145.1,25999,10783,15216,Rural,Rural
13259,"Stewart, Georgia",14.3,6545,0,6545,Rural,Rural
13261,"Sumter, Georgia",61.0,29468,17157,12311,Rural,Rural
13263,"Talbot, Georgia",15.9,6214,371,5843,Rural,Rural
13265,"Taliaferro, Georgia",7.9,1530,0,1530,Rural,Rural
13267,"Tattnall, Georgia",52.6,25210,7982,17228,Rural,Rural
13269,"Taylor, Georgia",21.3,8026,0,8026,Rural,Rural
13271,"Telfair, Georgia",36.1,15797,8424,7373,Rural,Rural
13273,"Terrell, Georgia",25.4,8523,4089,4434,Rural,Rural
13275,"Thomas, Georgia",81.7,44518,24050,20468,Rural,Rural
13277,"Tift, Georgia",157.4,40742,24045,16697,Rural,Rural
13279,"Toombs, Georgia",73.8,26865,13128,13737,Rural,Rural
13281,"Towns, Georgia",73.0,12156,0,12156,Rural,Rural
13283,"Treutlen, Georgia",34.8,6939,2869,4070,Rural,Rural
13285,"Troup, Georgia",168.7,69842,38814,31028,Urban,Rural
13287,"Turner, Georgia",28.1,8011,4025,3986,Rural,Rural
13289,"Twiggs, Georgia",22.7,8131,0,8131,Rural,Rural
13291,"Union, Georgia",77.2,24838,0,24838,Rural,Rural
13293,"Upson, Georgia",81.7,26417,13986,12431,Rural,Rural
13295,"Walker, Georgia",156.8,69992,39231,30761,Urban,Rural
13297,"Walton, Georgia",292.9,95403,54503,40900,Urban,Rural
13299,"Ware, Georgia",40.2,35858,25237,10621,Rural,Rural
13301,"Warren, Georgia",18.5,5263,0,5263,Rural,Rural
13303,"Washington, Georgia",30.1,20428,7031,13397,Rural,Rural
13305,"Wayne, Georgia",46.8,30017,12525,17492,Rural,Rural
13307,"Webster, Georgia",12.5,2611,0,2611,Rural,Rural
13309,"Wheeler, Georgia",26.5,7840,0,7840,Rural,Rural
13311,"White, Georgia",129.2,31092,5176,25916,Rural,Rural
13313,"Whitfield, Georgia",360.4,104680,74155,30525,Urban,Rural
13315,"Wilcox, Georgia",22.7,8587,0,8587,Rural,Rural
13317,"Wilkes, Georgia",20.9,9807,3230,6577,Rural,Rural
13319,"Wilkinson, Georgia",20.1,8982,0,8982,Rural,Rural
13321,"Worth, Georgia",35.5,20259,6250,14009,Rural,Rural
15001,"Hawaii, Hawaii",50.1,201959,125145,76814,Urban,Rural
15003,"Honolulu, Hawaii",1618.0,971975,963613,8362,Urban,Urban
15005,"Kalawao, Hawaii",7.3,87,0,87,Rural,Rural
15007,"Kauai, Hawaii",116.9,72456,63181,9275,Urban,Rural
15009,"Maui, Hawaii",144.3,167641,143137,24504,Urban,Rural
16001,"Ada, Idaho",462.8,487154,460614,26540,Urban,Rural
16003,"Adams, Idaho",3.2,4337,0,4337,Rural,Rural
16005,"Bannock, Idaho",79.3,88233,74459,13774,Urban,Rural
16007,"Bear Lake, Idaho",6.3,6148,0,6148,Rural,Rural
16009,"Benewah, Idaho",12.0,9339,2631,6708,Rural,Rural
16011,"Bingham, Idaho",22.4,46990,20686,26304,Rural,Rural
16013,"Blaine, Idaho",8.7,23021,15515,7506,Rural,Rural
16015,"Boise, Idaho",4.2,7908,0,7908,Rural,Rural
16017,"Bonner, Idaho",26.6,46173,12731,33442,Rural,Rural
16019,"Bonneville, Idaho",64.2,119890,104281,15609,Urban,Rural
16021,"Boundary, Idaho",9.7,12296,2901,9395,Rural,Rural
16023,"Butte, Idaho",1.2,2606,0,2606,Rural,Rural
16025,"Camas, Idaho",1.0,1113,0,1113,Rural,Rural
16027,"Canyon, Idaho",395.0,232022,185656,46366,Urban,Rural
16029,"Caribou, Idaho",4.1,7191,2862,4329,Rural,Rural
16031,"Cassia, Idaho",9.4,24062,11705,12357,Rural,Rural
16033,"Clark, Idaho",0.5,839,0,839,Rural,Rural
16035,"Clearwater, Idaho",3.6,8781,3714,5067,Rural,Rural
16037,"Custer, Idaho",0.9,4360,0,4360,Rural,Rural
16039,"Elmore, Idaho",9.0,27562,20196,7366,Rural,Rural
16041,"Franklin, Idaho",21.0,13961,4705,9256,Rural,Rural
16043,"Fremont, Idaho",7.0,13090,3646,9444,Rural,Rural
16045,"Gem, Idaho",32.6,18279,10053,8226,Rural,Rural
16047,"Gooding, Idaho",20.9,15206,6356,8850,Rural,Rural
16049,"Idaho, Idaho",2.0,16739,3242,13497,Rural,Rural
16051,"Jefferson, Idaho",27.5,30082,10123,19959,Rural,Rural
16053,"Jerome, Idaho",40.9,24424,11894,12530,Rural,Rural
16055,"Kootenai, Idaho",134.6,167496,126510,40986,Urban,Rural
16057,"Latah, Idaho",37.4,40220,25972,14248,Rural,Rural
16059,"Lemhi, Idaho",1.8,8086,3167,4919,Rural,Rural
16061,"Lewis, Idaho",8.0,3845,0,3845,Rural,Rural
16063,"Lincoln, Idaho",4.4,5343,0,5343,Rural,Rural
16065,"Madison, Idaho",84.6,39703,28387,11316,Rural,Rural
16067,"Minidoka, Idaho",27.9,21102,11789,9313,Rural,Rural
16069,"Nez Perce, Idaho",47.8,40563,32784,7779,Rural,Rural
16071,"Oneida, Idaho",3.8,4572,0,4572,Rural,Rural
16073,"Owyhee, Idaho",1.5,11868,2679,9189,Rural,Rural
16075,"Payette, Idaho",59.3,24110,13799,10311,Rural,Rural
16077,"Power, Idaho",5.5,7700,4437,3263,Rural,Rural
16079,"Shoshone, Idaho",4.9,12957,5685,7272,Rural,Rural
16081,"Teton, Idaho",27.2,12218,0,12218,Rural,Rural
16083,"Twin Falls, Idaho",45.4,87142,62509,24633,Urban,Rural
16085,"Valley, Idaho",3.1,11527,0,11527,Rural,Rural
16087,"Washington, Idaho",7.1,10252,5562,4690,Rural,Rural
17001,"Adams, Illinois",76.6,65494,44111,21383,Urban,Rural
17003,"Alexander, Illinois",24.2,5704,2206,3498,Rural,Rural
17005,"Bond, Illinois",43.3,16461,6255,10206,Rural,Rural
17007,"Boone, Illinois",191.0,53626,43229,10397,Urban,Rural
17009,"Brown, Illinois",21.6,6594,3848,2746,Rural,Rural
17011,"Bureau, Illinois",37.6,32633,13925,18708,Rural,Rural
17013,"Calhoun, Illinois",18.6,4727,0,4727,Rural,Rural
17015,"Carroll, Illinois",32.2,14311,2567,11744,Rural,Rural
17017,"Cass, Illinois",32.1,12062,5784,6278,Rural,Rural
17019,"Champaign, Illinois",209.9,209084,182646,26438,Urban,Rural
17021,"Christian, Illinois",45.5,32292,18272,14020,Rural,Rural
17023,"Clark, Illinois",30.7,15410,6251,9159,Rural,Rural
17025,"Clay, Illinois",28.2,13201,4616,8585,Rural,Rural
17027,"Clinton, Illinois",79.3,37592,19227,18365,Rural,Rural
17029,"Coles, Illinois",99.7,50655,38186,12469,Urban,Rural
17031,"Cook, Illinois",5439.1,5141687,5139364,2323,Urban,Urban
17033,"Crawford, Illinois",42.1,18657,7458,11199,Rural,Rural
17035,"Cumberland, Illinois",31.2,10781,0,10781,Rural,Rural
17037,"Dekalb, Illinois",166.4,105059,83398,21661,Urban,Rural
17039,"De Witt, Illinois",39.3,15623,8000,7623,Rural,Rural
17041,"Douglas, Illinois",46.7,19465,7474,11991,Rural,Rural
17043,"Dupage, Illinois",2813.7,921485,921045,440,Urban,Urban
17045,"Edgar, Illinois",27.5,17161,8298,8863,Rural,Rural
17047,"Edwards, Illinois",28.7,6390,0,6390,Rural,Rural
17049,"Effingham, Illinois",71.1,34043,13691,20352,Rural,Rural
17051,"Fayette, Illinois",29.8,21360,7045,14315,Rural,Rural
17053,"Ford, Illinois",26.7,12962,7562,5400,Rural,Rural
17055,"Franklin, Illinois",94.1,38474,19731,18743,Rural,Rural
17057,"Fulton, Illinois",39.6,34314,13825,20489,Rural,Rural
17059,"Gallatin, Illinois",14.9,4819,0,4819,Rural,Rural
17061,"Greene, Illinois",23.9,12965,3712,9253,Rural,Rural
17063,"Grundy, Illinois",122.5,51218,38764,12454,Urban,Rural
17065,"Hamilton, Illinois",18.7,8122,2619,5503,Rural,Rural
17067,"Hancock, Illinois",22.3,17709,5149,12560,Rural,Rural
17069,"Hardin, Illinois",21.6,3836,0,3836,Rural,Rural
17071,"Henderson, Illinois",17.5,6643,23,6620,Rural,Rural
17073,"Henry, Illinois",59.5,48932,24256,24676,Rural,Rural
17075,"Iroquois, Illinois",24.3,27127,7608,19519,Rural,Rural
17077,"Jackson, Illinois",96.9,56609,35439,21170,Urban,Rural
17079,"Jasper, Illinois",19.5,9619,2900,6719,Rural,Rural
17081,"Jefferson, Illinois",66.0,37706,15509,22197,Rural,Rural
17083,"Jersey, Illinois",59.1,21812,8584,13228,Rural,Rural
17085,"Jo Daviess, Illinois",35.3,21246,5773,15473,Rural,Rural
17087,"Johnson, Illinois",36.4,12518,0,12518,Rural,Rural
17089,"Kane, Illinois",1025.1,533112,513961,19151,Urban,Urban
17091,"Kankakee, Illinois",162.2,109762,83197,26565,Urban,Rural
17093,"Kendall, Illinois",404.3,129522,116001,13521,Urban,Rural
17095,"Knox, Illinois",69.2,49610,37577,12033,Rural,Rural
17097,"Lake, Illinois",1568.7,695969,687107,8862,Urban,Urban
17099,"Lasalle, Illinois",95.9,108823,75834,32989,Urban,Rural
17101,"Lawrence, Illinois",42.1,15666,6509,9157,Rural,Rural
17103,"Lee, Illinois",47.0,34037,16056,17981,Rural,Rural
17105,"Livingston, Illinois",34.2,35684,20948,14736,Rural,Rural
17107,"Logan, Illinois",46.4,28651,17250,11401,Rural,Rural
17109,"Mcdonough, Illinois",50.2,29617,20748,8869,Rural,Rural
17111,"Mchenry, Illinois",511.1,308253,277812,30441,Urban,Urban
17113,"Mclean, Illinois",144.7,171285,143164,28121,Urban,Rural
17115,"Macon, Illinois",179.1,103995,88032,15963,Urban,Rural
17117,"Macoupin, Illinois",52.1,44932,18623,26309,Rural,Rural
17119,"Madison, Illinois",367.9,263254,227957,35297,Urban,Rural
17121,"Marion, Illinois",65.1,37255,20441,16814,Rural,Rural
17123,"Marshall, Illinois",29.6,11448,0,11448,Rural,Rural
17125,"Mason, Illinois",24.8,13352,3013,10339,Rural,Rural
17127,"Massac, Illinois",58.0,13759,6837,6922,Rural,Rural
17129,"Menard, Illinois",38.8,12202,2937,9265,Rural,Rural
17131,"Mercer, Illinois",27.6,15472,3434,12038,Rural,Rural
17133,"Monroe, Illinois",90.3,34748,20437,14311,Rural,Rural
17135,"Montgomery, Illinois",40.3,28385,16514,11871,Rural,Rural
17137,"Morgan, Illinois",59.0,33554,21500,12054,Rural,Rural
17139,"Moultrie, Illinois",43.3,14551,4442,10109,Rural,Rural
17141,"Ogle, Illinois",66.9,50723,26838,23885,Urban,Rural
17143,"Peoria, Illinois",288.5,178639,152561,26078,Urban,Rural
17145,"Perry, Illinois",47.3,20914,11780,9134,Rural,Rural
17147,"Piatt, Illinois",37.3,16363,5282,11081,Rural,Rural
17149,"Pike, Illinois",18.7,15582,4253,11329,Rural,Rural
17151,"Pope, Illinois",11.4,4209,0,4209,Rural,Rural
17153,"Pulaski, Illinois",26.7,5323,0,5323,Rural,Rural
17155,"Putnam, Illinois",35.9,5752,0,5752,Rural,Rural
17157,"Randolph, Illinois",55.2,31763,18294,13469,Rural,Rural
17159,"Richland, Illinois",43.2,15537,8790,6747,Rural,Rural
17161,"Rock Island, Illinois",331.8,141879,126460,15419,Urban,Rural
17163,"St Clair, Illinois",394.2,259303,233997,25306,Urban,Rural
17165,"Saline, Illinois",61.9,23520,13264,10256,Rural,Rural
17167,"Sangamon, Illinois",223.9,194375,166883,27492,Urban,Rural
17169,"Schuyler, Illinois",15.5,6777,2824,3953,Rural,Rural
17171,"Scott, Illinois",19.7,4953,0,4953,Rural,Rural
17173,"Shelby, Illinois",28.5,21646,4829,16817,Rural,Rural
17175,"Stark, Illinois",18.6,5346,0,5346,Rural,Rural
17177,"Stephenson, Illinois",78.8,44482,26671,17811,Rural,Rural
17179,"Tazewell, Illinois",203.1,131789,104797,26992,Urban,Rural
17181,"Union, Illinois",40.3,16660,5637,11023,Rural,Rural
17183,"Vermilion, Illinois",84.2,75598,51932,23666,Urban,Rural
17185,"Wabash, Illinois",51.6,11511,6999,4512,Rural,Rural
17187,"Warren, Illinois",31.0,16819,9137,7682,Rural,Rural
17189,"Washington, Illinois",24.7,13882,3662,10220,Rural,Rural
17191,"Wayne, Illinois",22.7,16222,4846,11376,Rural,Rural
17193,"White, Illinois",27.4,13544,5161,8383,Rural,Rural
17195,"Whiteside, Illinois",80.6,55173,34618,20555,Urban,Rural
17197,"Will, Illinois",826.7,691843,664663,27180,Urban,Urban
17199,"Williamson, Illinois",158.7,66668,43416,23252,Urban,Rural
17201,"Winnebago, Illinois",550.2,282447,260077,22370,Urban,Urban
17203,"Woodford, Illinois",72.9,38482,17417,21065,Rural,Rural
18001,"Adams, Indiana",105.7,35820,16546,19274,Rural,Rural
18003,"Allen, Indiana",578.6,380342,335148,45194,Urban,Urban
18005,"Bartholomew, Indiana",205.9,83784,55622,28162,Urban,Rural
18007,"Benton, Indiana",21.5,8758,0,8758,Rural,Rural
18009,"Blackford, Indiana",71.2,11746,5772,5974,Rural,Rural
18011,"Boone, Indiana",161.4,68257,44831,23426,Urban,Rural
18013,"Brown, Indiana",48.6,15150,0,15150,Rural,Rural
18015,"Carroll, Indiana",54.5,20278,3760,16518,Rural,Rural
18017,"Cass, Indiana",91.5,37701,20845,16856,Rural,Rural
18019,"Clark, Indiana",318.7,118841,94326,24515,Urban,Rural
18021,"Clay, Indiana",73.4,26255,10281,15974,Rural,Rural
18023,"Clinton, Indiana",80.1,32464,16332,16132,Rural,Rural
18025,"Crawford, Indiana",34.6,10589,0,10589,Rural,Rural
18027,"Daviess, Indiana",77.6,33346,13217,20129,Rural,Rural
18029,"Dearborn, Indiana",162.5,49577,23313,26264,Rural,Rural
18031,"Decatur, Indiana",71.4,26603,12309,14294,Rural,Rural
18033,"Dekalb, Indiana",120.2,43616,25230,18386,Rural,Rural
18035,"Delaware, Indiana",291.5,114291,88225,26066,Urban,Rural
18037,"Dubois, Indiana",100.0,42729,21780,20949,Rural,Rural
18039,"Elkhart, Indiana",446.0,206556,163876,42680,Urban,Rural
18041,"Fayette, Indiana",107.5,23123,14606,8517,Rural,Rural
18043,"Floyd, Indiana",532.8,78823,62774,16049,Urban,Urban
18045,"Fountain, Indiana",41.3,16351,5552,10799,Rural,Rural
18047,"Franklin, Indiana",59.2,22764,2538,20226,Rural,Rural
18049,"Fulton, Indiana",54.3,20009,6991,13018,Rural,Rural
18051,"Gibson, Indiana",69.0,33649,15480,18169,Rural,Rural
18053,"Grant, Indiana",158.9,65786,46757,19029,Urban,Rural
18055,"Greene, Indiana",58.8,31924,8098,23826,Rural,Rural
18057,"Hamilton, Indiana",863.4,340425,321230,19195,Urban,Urban
18059,"Hancock, Indiana",257.1,78664,54873,23791,Urban,Rural
18061,"Harrison, Indiana",84.1,40728,5741,34987,Rural,Rural
18063,"Hendricks, Indiana",421.4,171484,140983,30501,Urban,Rural
18065,"Henry, Indiana",122.8,48132,27702,20430,Rural,Rural
18067,"Howard, Indiana",282.4,82746,64888,17858,Urban,Rural
18069,"Huntington, Indiana",95.6,36589,17955,18634,Rural,Rural
18071,"Jackson, Indiana",86.9,44263,24880,19383,Rural,Rural
18073,"Jasper, Indiana",60.1,33615,10744,22871,Rural,Rural
18075,"Jay, Indiana",53.2,20424,9039,11385,Rural,Rural
18077,"Jefferson, Indiana",89.9,32430,17808,14622,Rural,Rural
18079,"Jennings, Indiana",73.8,27777,10971,16806,Rural,Rural
18081,"Johnson, Indiana",496.3,159025,136784,22241,Urban,Rural
18083,"Knox, Indiana",71.2,36718,23182,13536,Rural,Rural
18085,"Kosciusko, Indiana",149.7,79574,42520,37054,Urban,Rural
18087,"Lagrange, Indiana",104.3,39598,3286,36312,Rural,Rural
18089,"Lake, Indiana",974.6,486289,466772,19517,Urban,Urban
18091,"Laporte, Indiana",184.0,110084,70870,39214,Urban,Rural
18093,"Lawrence, Indiana",101.2,45472,18886,26586,Rural,Rural
18095,"Madison, Indiana",287.5,129911,99859,30052,Urban,Rural
18097,"Marion, Indiana",2431.7,963666,957803,5863,Urban,Urban
18099,"Marshall, Indiana",104.2,46235,16931,29304,Rural,Rural
18101,"Martin, Indiana",30.6,10273,2865,7408,Rural,Rural
18103,"Miami, Indiana",94.9,35487,19078,16409,Rural,Rural
18105,"Monroe, Indiana",376.2,148408,116645,31763,Urban,Rural
18107,"Montgomery, Indiana",76.1,38394,18220,20174,Rural,Rural
18109,"Morgan, Indiana",174.9,70648,35956,34692,Urban,Rural
18111,"Newton, Indiana",34.9,14008,0,14008,Rural,Rural
18113,"Noble, Indiana",116.5,47851,15284,32567,Rural,Rural
18115,"Ohio, Indiana",68.1,5869,0,5869,Rural,Rural
18117,"Orange, Indiana",49.4,19663,3299,16364,Rural,Rural
18119,"Owen, Indiana",54.1,20846,0,20846,Rural,Rural
18121,"Parke, Indiana",38.1,16948,4201,12747,Rural,Rural
18123,"Perry, Indiana",50.5,19281,8642,10639,Rural,Rural
18125,"Pike, Indiana",37.2,12430,0,12430,Rural,Rural
18127,"Porter, Indiana",409.0,171029,135326,35703,Urban,Rural
18129,"Posey, Indiana",62.1,25449,8434,17015,Rural,Rural
18131,"Pulaski, Indiana",28.4,12335,2373,9962,Rural,Rural
18133,"Putnam, Indiana",78.7,37798,13302,24496,Rural,Rural
18135,"Randolph, Indiana",54.5,24657,9428,15229,Rural,Rural
18137,"Ripley, Indiana",63.6,28378,4778,23600,Rural,Rural
18139,"Rush, Indiana",40.7,16614,6463,10151,Rural,Rural
18141,"St Joseph, Indiana",594.1,271994,247383,24611,Urban,Urban
18143,"Scott, Indiana",125.9,23964,11350,12614,Rural,Rural
18145,"Shelby, Indiana",109.1,44860,21416,23444,Rural,Rural
18147,"Spencer, Indiana",51.1,20274,0,20274,Rural,Rural
18149,"Starke, Indiana",74.5,23028,4056,18972,Rural,Rural
18151,"Steuben, Indiana",112.3,34693,11313,23380,Rural,Rural
18153,"Sullivan, Indiana",46.3,20707,4367,16340,Rural,Rural
18155,"Switzerland, Indiana",48.8,10775,0,10775,Rural,Rural
18157,"Tippecanoe, Indiana",391.0,195403,167220,28183,Urban,Rural
18159,"Tipton, Indiana",58.2,15174,5826,9348,Rural,Rural
18161,"Union, Indiana",43.8,7057,0,7057,Rural,Rural
18163,"Vanderburgh, Indiana",778.3,181713,164958,16755,Urban,Urban
18165,"Vermillion, Indiana",60.4,15510,6180,9330,Rural,Rural
18167,"Vigo, Indiana",265.4,107030,81770,25260,Urban,Rural
18169,"Wabash, Indiana",75.3,31045,15594,15451,Rural,Rural
18171,"Warren, Indiana",22.7,8278,1901,6377,Rural,Rural
18173,"Warrick, Indiana",164.3,63226,44760,18466,Urban,Rural
18175,"Washington, Indiana",54.7,28117,6525,21592,Rural,Rural
18177,"Wayne, Indiana",164.1,65916,44186,21730,Urban,Rural
18179,"Wells, Indiana",77.1,28395,14087,14308,Rural,Rural
18181,"White, Indiana",47.7,24105,7744,16361,Rural,Rural
18183,"Whitley, Indiana",101.4,34042,9856,24186,Rural,Rural
19001,"Adair, Iowa",12.6,7170,0,7170,Rural,Rural
19003,"Adams, Iowa",8.5,3604,0,3604,Rural,Rural
19005,"Allamakee, Iowa",21.4,13678,3553,10125,Rural,Rural
19007,"Appanoose, Iowa",25.0,12450,5192,7258,Rural,Rural
19009,"Audubon, Iowa",12.4,5506,0,5506,Rural,Rural
19011,"Benton, Iowa",35.9,25689,4994,20695,Rural,Rural
19013,"Black Hawk, Iowa",232.1,131305,113440,17865,Urban,Rural
19015,"Boone, Iowa",46.0,26284,12996,13288,Rural,Rural
19017,"Bremer, Iowa",57.7,25119,8867,16252,Rural,Rural
19019,"Buchanan, Iowa",37.1,21204,6667,14537,Rural,Rural
19021,"Buena Vista, Iowa",34.0,19526,10877,8649,Rural,Rural
19023,"Butler, Iowa",24.9,14455,0,14455,Rural,Rural
19025,"Calhoun, Iowa",17.0,9677,0,9677,Rural,Rural
19027,"Carroll, Iowa",35.4,20168,9707,10461,Rural,Rural
19029,"Cass, Iowa",22.7,12813,5946,6867,Rural,Rural
19031,"Cedar, Iowa",32.3,18697,3107,15590,Rural,Rural
19033,"Cerro Gordo, Iowa",74.7,42479,33660,8819,Rural,Rural
19035,"Cherokee, Iowa",19.5,11262,4345,6917,Rural,Rural
19037,"Chickasaw, Iowa",23.6,11923,3121,8802,Rural,Rural
19039,"Clarke, Iowa",21.8,9388,4829,4559,Rural,Rural
19041,"Clay, Iowa",28.2,16001,10546,5455,Rural,Rural
19043,"Clayton, Iowa",22.6,17560,603,16957,Rural,Rural
19045,"Clinton, Iowa",66.8,46418,31391,15027,Rural,Rural
19047,"Crawford, Iowa",23.5,16783,8055,8728,Rural,Rural
19049,"Dallas, Iowa",160.3,94355,65475,28880,Urban,Rural
19051,"Davis, Iowa",17.9,9006,0,9006,Rural,Rural
19053,"Decatur, Iowa",14.8,7866,0,7866,Rural,Rural
19055,"Delaware, Iowa",29.4,16992,4847,12145,Rural,Rural
19057,"Des Moines, Iowa",93.6,38952,28478,10474,Rural,Rural
19059,"Dickinson, Iowa",45.5,17330,11239,6091,Rural,Rural
19061,"Dubuque, Iowa",160.1,97411,70994,26417,Urban,Rural
19063,"Emmet, Iowa",23.2,9178,5505,3673,Rural,Rural
19065,"Fayette, Iowa",26.9,19665,5786,13879,Rural,Rural
19067,"Floyd, Iowa",31.2,15643,7371,8272,Rural,Rural
19069,"Franklin, Iowa",17.3,10075,4005,6070,Rural,Rural
19071,"Fremont, Iowa",13.6,6976,0,6976,Rural,Rural
19073,"Greene, Iowa",15.6,8905,3697,5208,Rural,Rural
19075,"Grundy, Iowa",24.4,12262,0,12262,Rural,Rural
19077,"Guthrie, Iowa",18.1,10709,0,10709,Rural,Rural
19079,"Hamilton, Iowa",25.6,14785,7223,7562,Rural,Rural
19081,"Hancock, Iowa",18.6,10620,3209,7411,Rural,Rural
19083,"Hardin, Iowa",29.5,16817,4850,11967,Rural,Rural
19085,"Harrison, Iowa",20.2,14088,2647,11441,Rural,Rural
19087,"Henry, Iowa",46.0,19962,8635,11327,Rural,Rural
19089,"Howard, Iowa",19.4,9170,3364,5806,Rural,Rural
19091,"Humboldt, Iowa",22.0,9559,5115,4444,Rural,Rural
19093,"Ida, Iowa",15.9,6874,0,6874,Rural,Rural
19095,"Iowa, Iowa",27.6,16214,2872,13342,Rural,Rural
19097,"Jackson, Iowa",30.6,19474,9139,10335,Rural,Rural
19099,"Jasper, Iowa",51.0,37262,15831,21431,Rural,Rural
19101,"Jefferson, Iowa",42.2,18371,11190,7181,Rural,Rural
19103,"Johnson, Iowa",246.7,151503,123329,28174,Urban,Rural
19105,"Jones, Iowa",36.0,20742,8664,12078,Rural,Rural
19107,"Keokuk, Iowa",17.7,10273,0,10273,Rural,Rural
19109,"Kossuth, Iowa",15.2,14813,5081,9732,Rural,Rural
19111,"Lee, Iowa",65.1,33690,19902,13788,Rural,Rural
19113,"Linn, Iowa",317.2,227370,198346,29024,Urban,Rural
19115,"Louisa, Iowa",27.4,11014,0,11014,Rural,Rural
19117,"Lucas, Iowa",20.0,8625,3740,4885,Rural,Rural
19119,"Lyon, Iowa",20.0,11753,0,11753,Rural,Rural
19121,"Madison, Iowa",29.3,16431,5261,11170,Rural,Rural
19123,"Mahaska, Iowa",38.7,22084,12384,9700,Rural,Rural
19125,"Marion, Iowa",60.2,33379,16974,16405,Rural,Rural
19127,"Marshall, Iowa",68.8,39366,25906,13460,Rural,Rural
19129,"Mills, Iowa",34.6,15143,6052,9091,Rural,Rural
19131,"Mitchell, Iowa",22.6,10609,3455,7154,Rural,Rural
19133,"Monona, Iowa",12.4,8634,2473,6161,Rural,Rural
19135,"Monroe, Iowa",17.8,7717,3476,4241,Rural,Rural
19137,"Montgomery, Iowa",23.4,9924,5145,4779,Rural,Rural
19139,"Muscatine, Iowa",97.5,42655,31763,10892,Rural,Rural
19141,"O'Brien, Iowa",24.1,13782,4666,9116,Rural,Rural
19143,"Osceola, Iowa",14.9,5960,2481,3479,Rural,Rural
19145,"Page, Iowa",28.3,15126,10090,5036,Rural,Rural
19147,"Palo Alto, Iowa",15.7,8880,3389,5491,Rural,Rural
19149,"Plymouth, Iowa",29.3,25240,9415,15825,Rural,Rural
19151,"Pocahontas, Iowa",11.4,6608,0,6608,Rural,Rural
19153,"Polk, Iowa",857.8,492228,467707,24521,Urban,Urban
19155,"Pottawattamie, Iowa",98.2,93310,68702,24608,Urban,Rural
19157,"Poweshiek, Iowa",31.8,18620,8944,9676,Rural,Rural
19159,"Ringgold, Iowa",9.2,4907,0,4907,Rural,Rural
19161,"Sac, Iowa",16.9,9731,0,9731,Rural,Rural
19163,"Scott, Iowa",378.3,173287,149802,23485,Urban,Rural
19165,"Shelby, Iowa",19.4,11476,4688,6788,Rural,Rural
19167,"Sioux, Iowa",45.4,34874,17075,17799,Rural,Rural
19169,"Story, Iowa",170.3,97573,81292,16281,Urban,Rural
19171,"Tama, Iowa",23.4,16853,4646,12207,Rural,Rural
19173,"Taylor, Iowa",11.5,6138,0,6138,Rural,Rural
19175,"Union, Iowa",28.9,12249,7458,4791,Rural,Rural
19177,"Van Buren, Iowa",14.5,7036,0,7036,Rural,Rural
19179,"Wapello, Iowa",81.0,34994,24367,10627,Rural,Rural
19181,"Warren, Iowa",90.9,51792,29890,21902,Urban,Rural
19183,"Washington, Iowa",38.7,21999,6669,15330,Rural,Rural
19185,"Wayne, Iowa",12.3,6448,0,6448,Rural,Rural
19187,"Webster, Iowa",50.0,35813,23662,12151,Rural,Rural
19189,"Winnebago, Iowa",25.8,10339,3535,6804,Rural,Rural
19191,"Winneshiek, Iowa",29.0,20000,8093,11907,Rural,Rural
19193,"Woodbury, Iowa",118.3,103240,85271,17969,Urban,Rural
19195,"Worth, Iowa",18.5,7395,0,7395,Rural,Rural
19197,"Wright, Iowa",21.6,12547,5401,7146,Rural,Rural
20001,"Allen, Kansas",24.7,12340,5343,6997,Rural,Rural
20003,"Anderson, Kansas",13.6,7875,3285,4590,Rural,Rural
20005,"Atchison, Kansas",37.3,16081,10600,5481,Rural,Rural
20007,"Barber, Kansas",3.9,4406,0,4406,Rural,Rural
20009,"Barton, Kansas",28.7,25721,17553,8168,Rural,Rural
20011,"Bourbon, Kansas",22.9,14570,7604,6966,Rural,Rural
20013,"Brown, Kansas",16.8,9572,3024,6548,Rural,Rural
20015,"Butler, Kansas",46.9,67021,39903,27118,Urban,Rural
20017,"Chase, Kansas",3.4,2664,0,2664,Rural,Rural
20019,"Chautauqua, Kansas",5.1,3251,0,3251,Rural,Rural
20021,"Cherokee, Kansas",33.9,19935,10165,9770,Rural,Rural
20023,"Cheyenne, Kansas",2.6,2662,0,2662,Rural,Rural
20025,"Clark, Kansas",2.1,1998,0,1998,Rural,Rural
20027,"Clay, Kansas",12.4,8006,4016,3990,Rural,Rural
20029,"Cloud, Kansas",12.3,8780,4923,3857,Rural,Rural
20031,"Coffey, Kansas",13.0,8181,2371,5810,Rural,Rural
20033,"Comanche, Kansas",2.2,1696,0,1696,Rural,Rural
20035,"Cowley, Kansas",31.0,34915,24098,10817,Rural,Rural
20037,"Crawford, Kansas",65.9,38845,25273,13572,Rural,Rural
20039,"Decatur, Kansas",3.2,2832,0,2832,Rural,Rural
20041,"Dickinson, Kansas",21.8,18466,6616,11850,Rural,Rural
20043,"Doniphan, Kansas",19.4,7616,2268,5348,Rural,Rural
20045,"Douglas, Kansas",269.1,122663,109038,13625,Urban,Rural
20047,"Edwards, Kansas",4.5,2799,0,2799,Rural,Rural
20049,"Elk, Kansas",3.9,2542,0,2542,Rural,Rural
20051,"Ellis, Kansas",31.7,28555,21235,7320,Rural,Rural
20053,"Ellsworth, Kansas",8.5,6103,2839,3264,Rural,Rural
20055,"Finney, Kansas",27.9,36362,29554,6808,Rural,Rural
20057,"Ford, Kansas",30.4,33385,27008,6377,Rural,Rural
20059,"Franklin, Kansas",44.7,25578,12258,13320,Rural,Rural
20061,"Geary, Kansas",80.8,31094,27523,3571,Rural,Rural
20063,"Gove, Kansas",2.5,2640,0,2640,Rural,Rural
20065,"Graham, Kansas",2.8,2490,0,2490,Rural,Rural
20067,"Grant, Kansas",12.4,7099,5693,1406,Rural,Rural
20069,"Gray, Kansas",6.9,5953,0,5953,Rural,Rural
20071,"Greeley, Kansas",1.6,1230,0,1230,Rural,Rural
20073,"Greenwood, Kansas",5.2,5999,2311,3688,Rural,Rural
20075,"Hamilton, Kansas",2.5,2526,0,2526,Rural,Rural
20077,"Harper, Kansas",6.8,5428,0,5428,Rural,Rural
20079,"Harvey, Kansas",63.9,34487,23848,10639,Rural,Rural
20081,"Haskell, Kansas",6.9,3957,0,3957,Rural,Rural
20083,"Hodgeman, Kansas",2.1,1788,0,1788,Rural,Rural
20085,"Jackson, Kansas",20.1,13166,3182,9984,Rural,Rural
20087,"Jefferson, Kansas",35.9,19128,228,18900,Rural,Rural
20089,"Jewell, Kansas",3.2,2881,0,2881,Rural,Rural
20091,"Johnson, Kansas",1276.3,604162,580686,23476,Urban,Urban
20093,"Kearny, Kansas",4.4,3822,0,3822,Rural,Rural
20095,"Kingman, Kansas",8.3,7189,2698,4491,Rural,Rural
20097,"Kiowa, Kansas",3.4,2478,0,2478,Rural,Rural
20099,"Labette, Kansas",30.3,19583,9310,10273,Rural,Rural
20101,"Lane, Kansas",2.1,1541,0,1541,Rural,Rural
20103,"Leavenworth, Kansas",177.0,81920,57806,24114,Urban,Rural
20105,"Lincoln, Kansas",4.1,2963,0,2963,Rural,Rural
20107,"Linn, Kansas",16.4,9727,0,9727,Rural,Rural
20109,"Logan, Kansas",2.6,2801,0,2801,Rural,Rural
20111,"Lyon, Kansas",39.2,33227,24448,8779,Rural,Rural
20113,"Mcpherson, Kansas",31.9,28614,16143,12471,Rural,Rural
20115,"Marion, Kansas",12.6,11916,2658,9258,Rural,Rural
20117,"Marshall, Kansas",10.8,9723,2827,6896,Rural,Rural
20119,"Meade, Kansas",4.1,4025,0,4025,Rural,Rural
20121,"Miami, Kansas",59.7,34386,16861,17525,Rural,Rural
20123,"Mitchell, Kansas",8.5,5981,3088,2893,Rural,Rural
20125,"Montgomery, Kansas",49.4,31784,17994,13790,Rural,Rural
20127,"Morris, Kansas",8.1,5625,0,5625,Rural,Rural
20129,"Morton, Kansas",3.5,2555,0,2555,Rural,Rural
20131,"Nemaha, Kansas",14.3,10266,2536,7730,Rural,Rural
20133,"Neosho, Kansas",27.9,15964,8743,7221,Rural,Rural
20135,"Ness, Kansas",2.6,2754,0,2754,Rural,Rural
20137,"Norton, Kansas",6.1,5363,2719,2644,Rural,Rural
20139,"Osage, Kansas",22.7,15990,2631,13359,Rural,Rural
20141,"Osborne, Kansas",3.8,3418,0,3418,Rural,Rural
20143,"Ottawa, Kansas",7.9,5722,0,5722,Rural,Rural
20145,"Pawnee, Kansas",8.5,6390,4356,2034,Rural,Rural
20147,"Phillips, Kansas",5.9,5242,2426,2816,Rural,Rural
20149,"Pottawatomie, Kansas",29.1,24491,10041,14450,Rural,Rural
20151,"Pratt, Kansas",12.4,9132,6212,2920,Rural,Rural
20153,"Rawlins, Kansas",2.4,2540,0,2540,Rural,Rural
20155,"Reno, Kansas",49.4,61963,42615,19348,Urban,Rural
20157,"Republic, Kansas",6.5,4645,0,4645,Rural,Rural
20159,"Rice, Kansas",13.2,9555,3490,6065,Rural,Rural
20161,"Riley, Kansas",120.8,73637,63609,10028,Urban,Rural
20163,"Rooks, Kansas",5.5,4908,0,4908,Rural,Rural
20165,"Rush, Kansas",4.3,3055,0,3055,Rural,Rural
20167,"Russell, Kansas",7.7,6861,4027,2834,Rural,Rural
20169,"Saline, Kansas",75.3,54203,46326,7877,Urban,Rural
20171,"Scott, Kansas",6.7,4818,3539,1279,Rural,Rural
20173,"Sedgwick, Kansas",517.9,516642,476880,39762,Urban,Urban
20175,"Seward, Kansas",33.0,21130,18699,2431,Rural,Rural
20177,"Shawnee, Kansas",325.3,176967,148934,28033,Urban,Rural
20179,"Sheridan, Kansas",2.8,2527,0,2527,Rural,Rural
20181,"Sherman, Kansas",5.6,5916,4476,1440,Rural,Rural
20183,"Smith, Kansas",4.0,3588,0,3588,Rural,Rural
20185,"Stafford, Kansas",5.3,4163,0,4163,Rural,Rural
20187,"Stanton, Kansas",2.9,1983,0,1983,Rural,Rural
20189,"Stevens, Kansas",7.5,5468,3774,1694,Rural,Rural
20191,"Sumner, Kansas",19.3,22826,8483,14343,Rural,Rural
20193,"Thomas, Kansas",7.2,7756,5365,2391,Rural,Rural
20195,"Trego, Kansas",3.2,2809,0,2809,Rural,Rural
20197,"Wabaunsee, Kansas",8.7,6942,0,6942,Rural,Rural
20199,"Wallace, Kansas",1.7,1520,0,1520,Rural,Rural
20201,"Washington, Kansas",6.0,5393,0,5393,Rural,Rural
20203,"Wichita, Kansas",2.9,2112,0,2112,Rural,Rural
20205,"Wilson, Kansas",14.9,8512,2325,6187,Rural,Rural
20207,"Woodson, Kansas",6.3,3147,0,3147,Rural,Rural
20209,"Wyandotte, Kansas",1090.4,165303,155168,10135,Urban,Urban
21001,"Adair, Kentucky",47.5,19260,4768,14492,Rural,Rural
21003,"Allen, Kentucky",62.2,21429,4537,16892,Rural,Rural
21005,"Anderson, Kentucky",113.1,22827,13338,9489,Rural,Rural
21007,"Ballard, Kentucky",32.0,7885,0,7885,Rural,Rural
21009,"Barren, Kentucky",91.1,44408,16344,28064,Rural,Rural
21011,"Bath, Kentucky",44.9,12521,0,12521,Rural,Rural
21013,"Bell, Kentucky",72.4,25981,9815,16166,Rural,Rural
21015,"Boone, Kentucky",543.5,133897,116097,17800,Urban,Urban
21017,"Bourbon, Kentucky",68.4,19811,10911,8900,Rural,Rural
21019,"Boyd, Kentucky",291.9,46668,34761,11907,Rural,Rural
21021,"Boyle, Kentucky",167.3,30137,19751,10386,Rural,Rural
21023,"Bracken, Kentucky",40.4,8303,0,8303,Rural,Rural
21025,"Breathitt, Kentucky",25.6,12587,2344,10243,Rural,Rural
21027,"Breckinridge, Kentucky",36.3,20572,0,20572,Rural,Rural
21029,"Bullitt, Kentucky",276.2,82027,57033,24994,Urban,Rural
21031,"Butler, Kentucky",30.3,12925,0,12925,Rural,Rural
21033,"Caldwell, Kentucky",37.1,12777,5780,6997,Rural,Rural
21035,"Calloway, Kentucky",101.8,39206,20081,19125,Rural,Rural
21037,"Campbell, Kentucky",618.6,93597,79191,14406,Urban,Urban
21039,"Carlisle, Kentucky",25.2,4773,0,4773,Rural,Rural
21041,"Carroll, Kentucky",82.8,10645,5081,5564,Rural,Rural
21043,"Carter, Kentucky",65.3,26756,5512,21244,Rural,Rural
21045,"Casey, Kentucky",36.5,16227,0,16227,Rural,Rural
21047,"Christian, Kentucky",98.2,70447,50563,19884,Urban,Rural
21049,"Clark, Kentucky",144.2,36413,26379,10034,Rural,Rural
21051,"Clay, Kentucky",42.4,19892,4102,15790,Rural,Rural
21053,"Clinton, Kentucky",52.0,10253,0,10253,Rural,Rural
21055,"Crittenden, Kentucky",24.5,8809,2573,6236,Rural,Rural
21057,"Cumberland, Kentucky",21.7,6613,0,6613,Rural,Rural
21059,"Daviess, Kentucky",222.2,101862,74233,27629,Urban,Rural
21061,"Edmonson, Kentucky",40.2,12187,0,12187,Rural,Rural
21063,"Elliott, Kentucky",32.2,7549,0,7549,Rural,Rural
21065,"Estill, Kentucky",55.9,14154,3370,10784,Rural,Rural
21067,"Fayette, Kentucky",1141.9,323890,313898,9992,Urban,Urban
21069,"Fleming, Kentucky",41.9,14596,2834,11762,Rural,Rural
21071,"Floyd, Kentucky",90.3,35516,5731,29785,Rural,Rural
21073,"Franklin, Kentucky",246.2,51137,37118,14019,Urban,Rural
21075,"Fulton, Kentucky",29.1,5977,2120,3857,Rural,Rural
21077,"Gallatin, Kentucky",88.1,8916,0,8916,Rural,Rural
21079,"Garrard, Kentucky",77.1,17742,3941,13801,Rural,Rural
21081,"Grant, Kentucky",97.4,25116,8811,16305,Rural,Rural
21083,"Graves, Kentucky",67.6,37298,11346,25952,Rural,Rural
21085,"Grayson, Kentucky",53.4,26514,6988,19526,Rural,Rural
21087,"Green, Kentucky",38.4,10978,0,10978,Rural,Rural
21089,"Greenup, Kentucky",101.9,35101,21304,13797,Rural,Rural
21091,"Hancock, Kentucky",46.5,8732,920,7812,Rural,Rural
21093,"Hardin, Kentucky",178.8,111419,73213,38206,Urban,Rural
21095,"Harlan, Kentucky",55.8,26005,11935,14070,Rural,Rural
21097,"Harrison, Kentucky",61.8,18946,6467,12479,Rural,Rural
21099,"Hart, Kentucky",46.3,19092,2452,16640,Rural,Rural
21101,"Henderson, Kentucky",103.5,45206,27931,17275,Rural,Rural
21103,"Henry, Kentucky",56.6,16195,0,16195,Rural,Rural
21105,"Hickman, Kentucky",18.0,4365,0,4365,Rural,Rural
21107,"Hopkins, Kentucky",82.5,44706,23582,21124,Rural,Rural
21109,"Jackson, Kentucky",38.7,13363,0,13363,Rural,Rural
21111,"Jefferson, Kentucky",2019.3,768182,757553,10629,Urban,Urban
21113,"Jessamine, Kentucky",316.1,54401,40272,14129,Urban,Rural
21115,"Johnson, Kentucky",84.7,22187,5971,16216,Rural,Rural
21117,"Kenton, Kentucky",1044.0,167308,155575,11733,Urban,Urban
21119,"Knott, Kentucky",42.1,14796,0,14796,Rural,Rural
21121,"Knox, Kentucky",80.6,31143,11587,19556,Rural,Rural
21123,"Larue, Kentucky",55.3,14459,3458,11001,Rural,Rural
21125,"Laurel, Kentucky",140.5,60974,26217,34757,Urban,Rural
21127,"Lawrence, Kentucky",36.8,15289,3508,11781,Rural,Rural
21129,"Lee, Kentucky",35.2,7356,0,7356,Rural,Rural
21131,"Leslie, Kentucky",24.6,9850,0,9850,Rural,Rural
21133,"Letcher, Kentucky",63.6,21497,0,21497,Rural,Rural
21135,"Lewis, Kentucky",27.5,13270,0,13270,Rural,Rural
21137,"Lincoln, Kentucky",73.6,24593,4552,20041,Rural,Rural
21139,"Livingston, Kentucky",29.4,9210,430,8780,Rural,Rural
21141,"Logan, Kentucky",49.2,27161,6774,20387,Rural,Rural
21143,"Lyon, Kentucky",38.3,8180,0,8180,Rural,Rural
21145,"Mccracken, Kentucky",263.5,65549,47379,18170,Urban,Rural
21147,"Mccreary, Kentucky",40.5,17287,0,17287,Rural,Rural
21149,"Mclean, Kentucky",36.5,9216,0,9216,Rural,Rural
21151,"Madison, Kentucky",213.6,93427,57457,35970,Urban,Rural
21153,"Magoffin, Kentucky",39.4,12144,0,12144,Rural,Rural
21155,"Marion, Kentucky",56.4,19342,5573,13769,Rural,Rural
21157,"Marshall, Kentucky",103.5,31193,4434,26759,Rural,Rural
21159,"Martin, Kentucky",48.6,11150,0,11150,Rural,Rural
21161,"Mason, Kentucky",71.2,17094,7625,9469,Rural,Rural
21163,"Meade, Kentucky",94.1,28744,3995,24749,Rural,Rural
21165,"Menifee, Kentucky",32.0,6515,0,6515,Rural,Rural
21167,"Mercer, Kentucky",88.7,22066,8956,13110,Rural,Rural
21169,"Metcalfe, Kentucky",34.8,10080,0,10080,Rural,Rural
21171,"Monroe, Kentucky",32.4,10684,0,10684,Rural,Rural
21173,"Montgomery, Kentucky",143.3,28279,11543,16736,Rural,Rural
21175,"Morgan, Kentucky",35.1,13368,0,13368,Rural,Rural
21177,"Muhlenberg, Kentucky",65.5,30607,9705,20902,Rural,Rural
21179,"Nelson, Kentucky",111.1,46384,19986,26398,Rural,Rural
21181,"Nicholas, Kentucky",37.4,7296,0,7296,Rural,Rural
21183,"Ohio, Kentucky",40.9,24040,6330,17710,Rural,Rural
21185,"Oldham, Kentucky",357.0,66836,53134,13702,Urban,Rural
21187,"Owen, Kentucky",31.2,10938,0,10938,Rural,Rural
21189,"Owsley, Kentucky",22.4,4419,0,4419,Rural,Rural
21191,"Pendleton, Kentucky",52.6,14585,0,14585,Rural,Rural
21193,"Perry, Kentucky",75.5,25655,6640,19015,Rural,Rural
21195,"Pike, Kentucky",73.4,57756,7305,50451,Urban,Rural
21197,"Powell, Kentucky",69.4,12430,4053,8377,Rural,Rural
21199,"Pulaski, Kentucky",99.1,65247,30044,35203,Urban,Rural
21201,"Robertson, Kentucky",21.2,2114,0,2114,Rural,Rural
21203,"Rockcastle, Kentucky",52.7,16696,2714,13982,Rural,Rural
21205,"Rowan, Kentucky",87.5,24470,7949,16521,Rural,Rural
21207,"Russell, Kentucky",70.9,17993,0,17993,Rural,Rural
21209,"Scott, Kentucky",204.0,57473,38653,18820,Urban,Rural
21211,"Shelby, Kentucky",130.3,49463,26173,23290,Rural,Rural
21213,"Simpson, Kentucky",79.9,18716,10238,8478,Rural,Rural
21215,"Spencer, Kentucky",103.9,19404,0,19404,Rural,Rural
21217,"Taylor, Kentucky",97.0,25824,12426,13398,Rural,Rural
21219,"Todd, Kentucky",32.9,12303,0,12303,Rural,Rural
21221,"Trigg, Kentucky",33.3,14711,3048,11663,Rural,Rural
21223,"Trimble, Kentucky",56.0,8492,457,8035,Rural,Rural
21225,"Union, Kentucky",42.0,14384,5184,9200,Rural,Rural
21227,"Warren, Kentucky",247.1,133825,92060,41765,Urban,Rural
21229,"Washington, Kentucky",41.0,12179,0,12179,Rural,Rural
21231,"Wayne, Kentucky",44.4,20334,6586,13748,Rural,Rural
21233,"Webster, Kentucky",39.0,12954,0,12954,Rural,Rural
21235,"Whitley, Kentucky",83.2,36409,12652,23757,Rural,Rural
21237,"Wolfe, Kentucky",32.2,7155,0,7155,Rural,Rural
21239,"Woodford, Kentucky",142.4,26877,17131,9746,Rural,Rural
22001,"Acadia, Louisiana",94.6,61989,29980,32009,Urban,Rural
22003,"Allen, Louisiana",33.7,25676,7814,17862,Rural,Rural
22005,"Ascension, Louisiana",438.3,127103,110315,16788,Urban,Rural
22007,"Assumption, Louisiana",64.4,21818,12031,9787,Rural,Rural
22009,"Avoyelles, Louisiana",48.2,40123,14499,25624,Rural,Rural
22011,"Beauregard, Louisiana",32.5,37596,12562,25034,Rural,Rural
22013,"Bienville, Louisiana",16.3,13206,2689,10517,Rural,Rural
22015,"Bossier, Louisiana",151.6,127361,96289,31072,Urban,Rural
22017,"Caddo, Louisiana",272.7,239555,204942,34613,Urban,Rural
22019,"Calcasieu, Louisiana",191.6,203807,161737,42070,Urban,Rural
22021,"Caldwell, Louisiana",18.7,9922,0,9922,Rural,Rural
22023,"Cameron, Louisiana",5.4,6937,0,6937,Rural,Rural
22025,"Catahoula, Louisiana",13.4,9463,0,9463,Rural,Rural
22027,"Claiborne, Louisiana",20.8,15679,2726,12953,Rural,Rural
22029,"Concordia, Louisiana",27.5,19192,12736,6456,Rural,Rural
22031,"De Soto, Louisiana",31.5,27557,6224,21333,Rural,Rural
22033,"East Baton Rouge, Louisiana",964.4,439143,409120,30023,Urban,Urban
22035,"East Carroll, Louisiana",16.3,6839,4435,2404,Rural,Rural
22037,"East Feliciana, Louisiana",42.2,19155,0,19155,Rural,Rural
22039,"Evangeline, Louisiana",50.4,33372,12903,20469,Rural,Rural
22041,"Franklin, Louisiana",32.0,20001,5099,14902,Rural,Rural
22043,"Grant, Louisiana",34.9,22450,3256,19194,Rural,Rural
22045,"Iberia, Louisiana",121.2,69594,49857,19737,Urban,Rural
22047,"Iberville, Louisiana",52.6,32528,13196,19332,Rural,Rural
22049,"Jackson, Louisiana",27.7,15757,5441,10316,Rural,Rural
22051,"Jefferson, Louisiana",1462.2,432282,427342,4940,Urban,Urban
22053,"Jefferson Davis, Louisiana",48.3,31440,15417,16023,Rural,Rural
22055,"Lafayette, Louisiana",911.1,244823,224299,20524,Urban,Urban
22057,"Lafourche, Louisiana",91.4,97658,74035,23623,Urban,Rural
22059,"La Salle, Louisiana",23.9,14910,3993,10917,Rural,Rural
22061,"Lincoln, Louisiana",99.0,46719,27697,19022,Rural,Rural
22063,"Livingston, Louisiana",218.0,141300,83281,58019,Urban,Rural
22065,"Madison, Louisiana",17.5,10897,8454,2443,Rural,Rural
22067,"Morehouse, Louisiana",31.2,24816,12392,12424,Rural,Rural
22069,"Natchitoches, Louisiana",30.4,38093,19114,18979,Rural,Rural
22071,"Orleans, Louisiana",2303.2,390214,387892,2322,Urban,Urban
22073,"Ouachita, Louisiana",250.7,153043,115642,37401,Urban,Rural
22075,"Plaquemines, Louisiana",29.7,23189,18632,4557,Rural,Rural
22077,"Pointe Coupee, Louisiana",39.0,21756,9163,12593,Rural,Rural
22079,"Rapides, Louisiana",98.4,129661,78136,51525,Urban,Rural
22081,"Red River, Louisiana",21.7,8425,0,8425,Rural,Rural
22083,"Richland, Louisiana",35.9,20095,6769,13326,Rural,Rural
22085,"Sabine, Louisiana",27.6,23944,2805,21139,Rural,Rural
22087,"St Bernard, Louisiana",125.5,47373,45349,2024,Rural,Rural
22089,"St Charles, Louisiana",190.7,53228,47079,6149,Urban,Rural
22091,"St Helena, Louisiana",24.8,10142,0,10142,Rural,Rural
22093,"St James, Louisiana",87.1,21046,15210,5836,Rural,Rural
22095,"St John The Baptist, Louisiana",200.9,42809,37105,5704,Rural,Rural
22097,"St Landry, Louisiana",88.8,82041,42368,39673,Urban,Rural
22099,"St Martin, Louisiana",72.4,53436,26969,26467,Urban,Rural
22101,"St Mary, Louisiana",88.4,49119,42702,6417,Rural,Rural
22103,"St Tammany, Louisiana",309.5,261693,200785,60908,Urban,Rural
22105,"Tangipahoa, Louisiana",170.9,135267,79676,55591,Urban,Rural
22107,"Tensas, Louisiana",7.1,4301,0,4301,Rural,Rural
22109,"Terrebonne, Louisiana",89.5,110262,87487,22775,Urban,Rural
22111,"Union, Louisiana",25.3,22151,3818,18333,Rural,Rural
22113,"Vermilion, Louisiana",50.7,59529,27007,32522,Urban,Rural
22115,"Vernon, Louisiana",35.6,47214,23899,23315,Rural,Rural
22117,"Washington, Louisiana",69.1,46248,15328,30920,Rural,Rural
22119,"Webster, Louisiana",64.6,38281,17986,20295,Rural,Rural
22121,"West Baton Rouge, Louisiana",138.0,26549,18485,8064,Rural,Rural
22123,"West Carroll, Louisiana",30.1,10831,0,10831,Rural,Rural
22125,"West Feliciana, Louisiana",38.7,15615,0,15615,Rural,Rural
22127,"Winn, Louisiana",14.6,13859,4812,9047,Rural,Rural
23001,"Androscoggin, Maine",231.7,108421,61537,46884,Urban,Rural
23003,"Aroostook, Maine",10.1,67059,13245,53814,Urban,Rural
23005,"Cumberland, Maine",354.1,295766,188985,106781,Urban,Rural
23007,"Franklin, Maine",17.9,30320,5176,25144,Rural,Rural
23009,"Hancock, Maine",34.8,55212,5411,49801,Urban,Rural
23011,"Kennebec, Maine",141.3,122609,45564,77045,Urban,Rural
23013,"Knox, Maine",109.3,39899,12769,27130,Rural,Rural
23015,"Lincoln, Maine",76.3,34773,0,34773,Rural,Rural
23017,"Oxford, Maine",28.0,58150,9872,48278,Urban,Rural
23019,"Penobscot, Maine",44.9,152403,64827,87576,Urban,Rural
23021,"Piscataquis, Maine",4.3,16843,0,16843,Rural,Rural
23023,"Sagadahoc, Maine",141.8,35986,13820,22166,Rural,Rural
23025,"Somerset, Maine",12.9,50658,9827,40831,Urban,Rural
23027,"Waldo, Maine",54.6,39833,3445,36388,Rural,Rural
23029,"Washington, Maine",12.3,31523,2409,29114,Rural,Rural
23031,"York, Maine",210.6,208640,90155,118485,Urban,Rural
24001,"Allegany, Maryland",166.1,70473,51255,19218,Urban,Rural
24003,"Anne Arundel, Maryland",1400.2,580939,550135,30804,Urban,Urban
24005,"Baltimore, Maryland",1384.3,828241,774139,54102,Urban,Urban
24009,"Calvert, Maryland",435.4,92797,56821,35976,Urban,Rural
24011,"Caroline, Maryland",104.9,33496,8001,25495,Rural,Rural
24013,"Carroll, Maryland",377.6,168996,102229,66767,Urban,Rural
24015,"Cecil, Maryland",297.8,103108,59703,43405,Urban,Rural
24017,"Charles, Maryland",358.3,164018,115709,48309,Urban,Rural
24019,"Dorchester, Maryland",59.1,31955,14070,17885,Rural,Rural
24021,"Frederick, Maryland",395.6,261206,195333,65873,Urban,Rural
24023,"Garrett, Maryland",44.9,29058,4668,24390,Rural,Rural
24025,"Harford, Maryland",586.6,256399,210818,45581,Urban,Urban
24027,"Howard, Maryland",1305.0,327213,296855,30358,Urban,Urban
24029,"Kent, Maryland",70.2,19455,5382,14073,Rural,Rural
24031,"Montgomery, Maryland",2140.9,1051715,1026468,25247,Urban,Urban
24033,"Prince George'S, Maryland",1881.0,907925,889983,17942,Urban,Urban
24035,"Queen Anne'S, Maryland",136.1,50635,23068,27567,Urban,Rural
24037,"St Mary'S, Maryland",318.5,113763,56368,57395,Urban,Rural
24039,"Somerset, Maryland",80.3,25663,13844,11819,Rural,Rural
24041,"Talbot, Maryland",138.7,37249,16858,20391,Rural,Rural
24043,"Washington, Maryland",331.0,151544,107008,44536,Urban,Rural
24045,"Wicomico, Maryland",277.7,103987,77211,26776,Urban,Rural
24047,"Worcester, Maryland",112.3,52568,33752,18816,Urban,Rural
24510,"Baltimore City, Maryland",7301.7,591025,591025,0,Urban,Urban
25001,"Barnstable, Massachusetts",542.4,213558,197498,16060,Urban,Urban
25003,"Berkshire, Massachusetts",135.0,125118,85550,39568,Urban,Rural
25005,"Bristol, Massachusetts",1024.4,566571,510843,55728,Urban,Urban
25007,"Dukes, Massachusetts",168.2,17365,10658,6707,Rural,Rural
25009,"Essex, Massachusetts",1605.0,790584,757070,33514,Urban,Urban
25011,"Franklin, Massachusetts",100.6,70350,32061,38289,Urban,Rural
25013,"Hampden, Massachusetts",757.1,467210,427299,39911,Urban,Urban
25015,"Hampshire, Massachusetts",305.4,161026,117437,43589,Urban,Rural
25017,"Middlesex, Massachusetts",1972.6,1613205,1563971,49234,Urban,Urban
25019,"Nantucket, Massachusetts",254.5,11444,9302,2142,Rural,Rural
25021,"Norfolk, Massachusetts",1788.2,708325,699460,8865,Urban,Urban
25023,"Plymouth, Massachusetts",792.7,522420,468543,53877,Urban,Urban
25025,"Suffolk, Massachusetts",13810.8,803156,802578,578,Urban,Urban
25027,"Worcester, Massachusetts",550.9,832339,679193,153146,Urban,Urban
26001,"Alcona, Michigan",15.5,10468,112,10356,Rural,Rural
26003,"Alger, Michigan",10.0,9127,2849,6278,Rural,Rural
26005,"Allegan, Michigan",143.6,118523,42099,76424,Urban,Rural
26007,"Alpena, Michigan",49.7,28433,13728,14705,Rural,Rural
26009,"Antrim, Michigan",49.3,23435,0,23435,Rural,Rural
26011,"Arenac, Michigan",41.1,14926,0,14926,Rural,Rural
26013,"Baraga, Michigan",9.1,8202,0,8202,Rural,Rural
26015,"Barry, Michigan",111.7,61769,14153,47616,Urban,Rural
26017,"Bay, Michigan",233.5,103283,71894,31389,Urban,Rural
26019,"Benzie, Michigan",55.8,17846,0,17846,Rural,Rural
26021,"Berrien, Michigan",270.4,153540,103107,50433,Urban,Rural
26023,"Branch, Michigan",86.1,43581,15558,28023,Rural,Rural
26025,"Calhoun, Michigan",190.3,134374,92670,41704,Urban,Rural
26027,"Cass, Michigan",105.9,51901,14894,37007,Urban,Rural
26029,"Charlevoix, Michigan",62.9,26199,7730,18469,Rural,Rural
26031,"Cheboygan, Michigan",35.4,25310,4371,20939,Rural,Rural
26033,"Chippewa, Michigan",24.0,37399,19054,18345,Rural,Rural
26035,"Clare, Michigan",55.1,31079,9137,21942,Rural,Rural
26037,"Clinton, Michigan",141.1,79912,37549,42363,Urban,Rural
26039,"Crawford, Michigan",25.3,14076,3844,10232,Rural,Rural
26041,"Delta, Michigan",30.6,35868,20120,15748,Rural,Rural
26043,"Dickinson, Michigan",33.2,25277,16979,8298,Rural,Rural
26045,"Eaton, Michigan",192.1,110494,68514,41980,Urban,Rural
26047,"Emmet, Michigan",71.8,33587,8386,25201,Rural,Rural
26049,"Genesee, Michigan",637.3,405946,337666,68280,Urban,Urban
26051,"Gladwin, Michigan",50.9,25558,2893,22665,Rural,Rural
26053,"Gogebic, Michigan",13.0,14313,4805,9508,Rural,Rural
26055,"Grand Traverse, Michigan",201.1,93397,48663,44734,Urban,Rural
26057,"Gratiot, Michigan",71.8,40801,16375,24426,Rural,Rural
26059,"Hillsdale, Michigan",76.3,45635,14068,31567,Rural,Rural
26061,"Houghton, Michigan",35.3,35666,22278,13388,Rural,Rural
26063,"Huron, Michigan",37.1,30999,3228,27771,Rural,Rural
26065,"Ingham, Michigan",525.7,292346,253483,38863,Urban,Urban
26067,"Ionia, Michigan",113.5,64832,25407,39425,Urban,Rural
26069,"Iosco, Michigan",45.9,25206,10318,14888,Rural,Rural
26071,"Iron, Michigan",9.5,11105,2997,8108,Rural,Rural
26073,"Isabella, Michigan",121.3,69485,36677,32808,Urban,Rural
26075,"Jackson, Michigan",226.2,158744,91748,66996,Urban,Rural
26077,"Kalamazoo, Michigan",472.7,265478,218578,46900,Urban,Rural
26079,"Kalkaska, Michigan",32.4,18149,2795,15354,Rural,Rural
26081,"Kent, Michigan",776.9,658027,554426,103601,Urban,Urban
26083,"Keweenaw, Michigan",4.0,2136,0,2136,Rural,Rural
26085,"Lake, Michigan",20.8,11793,0,11793,Rural,Rural
26087,"Lapeer, Michigan",136.4,87739,19819,67920,Urban,Rural
26089,"Leelanau, Michigan",62.9,21848,1912,19936,Rural,Rural
26091,"Lenawee, Michigan",131.7,98686,47429,51257,Urban,Rural
26093,"Livingston, Michigan",340.9,192671,121518,71153,Urban,Rural
26095,"Luce, Michigan",6.9,6223,3092,3131,Rural,Rural
26097,"Mackinac, Michigan",10.6,10825,2462,8363,Rural,Rural
26099,"Macomb, Michigan",1828.4,876216,851531,24685,Urban,Urban
26101,"Manistee, Michigan",45.5,24650,9550,15100,Rural,Rural
26103,"Marquette, Michigan",37.0,66996,39114,27882,Urban,Rural
26105,"Mason, Michigan",59.0,29227,10933,18294,Rural,Rural
26107,"Mecosta, Michigan",78.5,43589,14463,29126,Rural,Rural
26109,"Menominee, Michigan",21.9,22828,8146,14682,Rural,Rural
26111,"Midland, Michigan",161.3,83251,47580,35671,Urban,Rural
26113,"Missaukee, Michigan",26.8,15152,0,15152,Rural,Rural
26115,"Monroe, Michigan",274.9,151003,94312,56691,Urban,Rural
26117,"Montcalm, Michigan",90.8,64068,9886,54182,Urban,Rural
26119,"Montmorency, Michigan",17.2,9377,0,9377,Rural,Rural
26121,"Muskegon, Michigan",347.4,173436,132577,40859,Urban,Rural
26123,"Newaygo, Michigan",60.5,49187,7910,41277,Rural,Rural
26125,"Oakland, Michigan",1450.8,1258791,1198140,60651,Urban,Urban
26127,"Oceana, Michigan",51.8,26517,2663,23854,Rural,Rural
26129,"Ogemaw, Michigan",37.4,21096,0,21096,Rural,Rural
26131,"Ontonagon, Michigan",4.4,5718,0,5718,Rural,Rural
26133,"Osceola, Michigan",41.5,23505,0,23505,Rural,Rural
26135,"Oscoda, Michigan",14.6,8276,0,8276,Rural,Rural
26137,"Otsego, Michigan",48.1,24763,8529,16234,Rural,Rural
26139,"Ottawa, Michigan",519.6,292753,233091,59662,Urban,Urban
26141,"Presque Isle, Michigan",19.2,12629,2440,10189,Rural,Rural
26143,"Roscommon, Michigan",46.5,24186,8220,15966,Rural,Rural
26145,"Saginaw, Michigan",238.1,190495,131197,59298,Urban,Rural
26147,"St Clair, Michigan",221.3,159595,97787,61808,Urban,Rural
26149,"St Joseph, Michigan",122.1,61116,27883,33233,Urban,Rural
26151,"Sanilac, Michigan",42.8,41226,4041,37185,Rural,Rural
26153,"Schoolcraft, Michigan",7.0,8141,3336,4805,Rural,Rural
26155,"Shiawassee, Michigan",128.6,68221,30674,37547,Urban,Rural
26157,"Tuscola, Michigan",65.0,52220,8217,44003,Urban,Rural
26159,"Van Buren, Michigan",124.8,75817,22070,53747,Urban,Rural
26161,"Washtenaw, Michigan",520.3,367335,307159,60176,Urban,Urban
26163,"Wayne, Michigan",2855.2,1747584,1735274,12310,Urban,Urban
26165,"Wexford, Michigan",59.7,33744,12081,21663,Rural,Rural
27001,"Aitkin, Minnesota",8.8,15950,0,15950,Rural,Rural
27003,"Anoka, Minnesota",846.5,358093,309634,48459,Urban,Urban
27005,"Becker, Minnesota",26.3,34547,8390,26157,Rural,Rural
27007,"Beltrami, Minnesota",18.9,47343,15421,31922,Rural,Rural
27009,"Benton, Minnesota",100.5,41022,24549,16473,Rural,Rural
27011,"Big Stone, Minnesota",10.0,4997,0,4997,Rural,Rural
27013,"Blue Earth, Minnesota",90.7,67798,49365,18433,Urban,Rural
27015,"Brown, Minnesota",40.9,25016,16310,8706,Rural,Rural
27017,"Carlton, Minnesota",41.8,36007,16072,19935,Rural,Rural
27019,"Carver, Minnesota",298.1,105614,85676,19938,Urban,Rural
27021,"Cass, Minnesota",14.8,29924,0,29924,Rural,Rural
27023,"Chippewa, Minnesota",20.3,11794,5862,5932,Rural,Rural
27025,"Chisago, Minnesota",137.0,56834,25264,31570,Urban,Rural
27027,"Clay, Minnesota",61.5,64269,46052,18217,Urban,Rural
27029,"Clearwater, Minnesota",8.8,8825,0,8825,Rural,Rural
27031,"Cook, Minnesota",3.8,5463,0,5463,Rural,Rural
27033,"Cottonwood, Minnesota",17.5,11207,4256,6951,Rural,Rural
27035,"Crow Wing, Minnesota",65.4,65351,24347,41004,Urban,Rural
27037,"Dakota, Minnesota",765.1,430141,408786,21355,Urban,Urban
27039,"Dodge, Minnesota",47.8,21004,10114,10890,Rural,Rural
27041,"Douglas, Minnesota",60.1,38331,18010,20321,Rural,Rural
27043,"Faribault, Minnesota",19.2,13661,3053,10608,Rural,Rural
27045,"Fillmore, Minnesota",24.5,21098,1439,19659,Rural,Rural
27047,"Freeborn, Minnesota",42.9,30302,17285,13017,Rural,Rural
27049,"Goodhue, Minnesota",61.4,46450,24555,21895,Rural,Rural
27051,"Grant, Minnesota",11.0,6004,0,6004,Rural,Rural
27053,"Hennepin, Minnesota",2290.6,1268070,1239592,28478,Urban,Urban
27055,"Houston, Minnesota",33.7,18623,7925,10698,Rural,Rural
27057,"Hubbard, Minnesota",23.4,21626,3619,18007,Rural,Rural
27059,"Isanti, Minnesota",93.6,40788,15344,25444,Rural,Rural
27061,"Itasca, Minnesota",16.9,45217,9314,35903,Rural,Rural
27063,"Jackson, Minnesota",14.0,9843,3016,6827,Rural,Rural
27065,"Kanabec, Minnesota",31.4,16383,3666,12717,Rural,Rural
27067,"Kandiyohi, Minnesota",54.2,43152,23931,19221,Rural,Rural
27069,"Kittson, Minnesota",3.9,4295,0,4295,Rural,Rural
27071,"Koochiching, Minnesota",3.9,12223,6454,5769,Rural,Rural
27073,"Lac Qui Parle, Minnesota",8.7,6623,0,6623,Rural,Rural
27075,"Lake, Minnesota",5.1,10704,3526,7178,Rural,Rural
27077,"Lake Of The Woods, Minnesota",2.9,3755,0,3755,Rural,Rural
27079,"Le Sueur, Minnesota",64.5,28953,10953,18000,Rural,Rural
27081,"Lincoln, Minnesota",10.5,5646,0,5646,Rural,Rural
27083,"Lyon, Minnesota",35.5,25363,13181,12182,Rural,Rural
27085,"Mcleod, Minnesota",73.2,35959,19191,16768,Rural,Rural
27087,"Mahnomen, Minnesota",9.9,5527,0,5527,Rural,Rural
27089,"Marshall, Minnesota",5.3,9335,0,9335,Rural,Rural
27091,"Martin, Minnesota",27.6,19696,9058,10638,Rural,Rural
27093,"Meeker, Minnesota",38.3,23267,8039,15228,Rural,Rural
27095,"Mille Lacs, Minnesota",46.1,26396,7699,18697,Rural,Rural
27097,"Morrison, Minnesota",29.8,33477,9087,24390,Rural,Rural
27099,"Mower, Minnesota",56.3,40053,25671,14382,Rural,Rural
27101,"Murray, Minnesota",11.6,8194,0,8194,Rural,Rural
27103,"Nicollet, Minnesota",76.5,34332,25590,8742,Rural,Rural
27105,"Nobles, Minnesota",30.2,21624,12775,8849,Rural,Rural
27107,"Norman, Minnesota",7.3,6363,0,6363,Rural,Rural
27109,"Olmsted, Minnesota",243.0,158737,132202,26535,Urban,Rural
27111,"Otter Tail, Minnesota",29.9,58991,15476,43515,Urban,Rural
27113,"Pennington, Minnesota",22.9,14130,8980,5150,Rural,Rural
27115,"Pine, Minnesota",21.0,29702,3150,26552,Rural,Rural
27117,"Pipestone, Minnesota",19.5,9088,3884,5204,Rural,Rural
27119,"Polk, Minnesota",15.9,31371,16039,15332,Rural,Rural
27121,"Pope, Minnesota",16.9,11296,0,11296,Rural,Rural
27123,"Ramsey, Minnesota",3618.9,550844,549820,1024,Urban,Urban
27125,"Red Lake, Minnesota",9.4,4063,0,4063,Rural,Rural
27127,"Redwood, Minnesota",17.3,15174,4687,10487,Rural,Rural
27129,"Renville, Minnesota",14.8,14540,0,14540,Rural,Rural
27131,"Rice, Minnesota",135.2,66997,49511,17486,Urban,Rural
27133,"Rock, Minnesota",19.3,9327,4428,4899,Rural,Rural
27135,"Roseau, Minnesota",9.1,15140,2677,12463,Rural,Rural
27137,"St Louis, Minnesota",31.9,199427,124962,74465,Urban,Rural
27139,"Scott, Minnesota",419.9,149681,123890,25791,Urban,Rural
27141,"Sherburne, Minnesota",225.6,97678,54512,43166,Urban,Rural
27143,"Sibley, Minnesota",25.3,14884,0,14884,Rural,Rural
27145,"Stearns, Minnesota",119.9,161104,101178,59926,Urban,Rural
27147,"Steele, Minnesota",85.5,36721,25396,11325,Rural,Rural
27149,"Stevens, Minnesota",17.4,9790,5176,4614,Rural,Rural
27151,"Swift, Minnesota",12.5,9262,3012,6250,Rural,Rural
27153,"Todd, Minnesota",26.1,24675,5307,19368,Rural,Rural
27155,"Traverse, Minnesota",5.7,3262,0,3262,Rural,Rural
27157,"Wabasha, Minnesota",41.4,21644,7718,13926,Rural,Rural
27159,"Wadena, Minnesota",25.6,13737,4543,9194,Rural,Rural
27161,"Waseca, Minnesota",43.9,18603,9146,9457,Rural,Rural
27163,"Washington, Minnesota",686.4,263775,225498,38277,Urban,Urban
27165,"Watonwan, Minnesota",25.0,10854,4437,6417,Rural,Rural
27167,"Wilkin, Minnesota",8.3,6202,3114,3088,Rural,Rural
27169,"Winona, Minnesota",80.8,50590,32973,17617,Urban,Rural
27171,"Wright, Minnesota",210.1,138975,93779,45196,Urban,Rural
27173,"Yellow Medicine, Minnesota",12.8,9699,1858,7841,Rural,Rural
28001,"Adams, Mississippi",66.1,30586,19126,11460,Rural,Rural
28003,"Alcorn, Mississippi",92.7,37067,12539,24528,Rural,Rural
28005,"Amite, Mississippi",16.8,12302,0,12302,Rural,Rural
28007,"Attala, Mississippi",24.7,18183,6521,11662,Rural,Rural
28009,"Benton, Mississippi",20.4,8289,0,8289,Rural,Rural
28011,"Bolivar, Mississippi",34.8,30521,14097,16424,Rural,Rural
28013,"Calhoun, Mississippi",24.5,14356,0,14356,Rural,Rural
28015,"Carroll, Mississippi",15.8,9945,0,9945,Rural,Rural
28017,"Chickasaw, Mississippi",34.2,17139,2628,14511,Rural,Rural
28019,"Choctaw, Mississippi",19.7,8225,0,8225,Rural,Rural
28021,"Claiborne, Mississippi",18.3,8934,0,8934,Rural,Rural
28023,"Clarke, Mississippi",22.5,15530,0,15530,Rural,Rural
28025,"Clay, Mississippi",47.0,19294,8544,10750,Rural,Rural
28027,"Coahoma, Mississippi",39.7,21949,14874,7075,Rural,Rural
28029,"Copiah, Mississippi",36.1,28033,9572,18461,Rural,Rural
28031,"Covington, Mississippi",45.0,18639,0,18639,Rural,Rural
28033,"Desoto, Mississippi",390.9,186116,147780,38336,Urban,Rural
28035,"Forrest, Mississippi",160.8,74970,52530,22440,Urban,Rural
28037,"Franklin, Mississippi",13.7,7735,0,7735,Rural,Rural
28039,"George, Mississippi",51.6,24684,2843,21841,Rural,Rural
28041,"Greene, Mississippi",18.7,13318,0,13318,Rural,Rural
28043,"Grenada, Mississippi",49.2,20782,9967,10815,Rural,Rural
28045,"Hancock, Mississippi",101.0,47861,27478,20383,Rural,Rural
28047,"Harrison, Mississippi",364.2,209061,160753,48308,Urban,Rural
28049,"Hinds, Mississippi",265.5,230932,195549,35383,Urban,Rural
28051,"Holmes, Mississippi",22.4,16978,2246,14732,Rural,Rural
28053,"Humphreys, Mississippi",19.2,8027,4026,4001,Rural,Rural
28055,"Issaquena, Mississippi",3.2,1340,0,1340,Rural,Rural
28057,"Itawamba, Mississippi",44.0,23435,3263,20172,Rural,Rural
28059,"Jackson, Mississippi",199.3,144027,104865,39162,Urban,Rural
28061,"Jasper, Mississippi",24.2,16388,0,16388,Rural,Rural
28063,"Jefferson, Mississippi",13.4,6968,0,6968,Rural,Rural
28065,"Jefferson Davis, Mississippi",27.2,11127,0,11127,Rural,Rural
28067,"Jones, Mississippi",98.1,68190,26315,41875,Urban,Rural
28069,"Kemper, Mississippi",12.8,9840,0,9840,Rural,Rural
28071,"Lafayette, Mississippi",86.3,54534,29094,25440,Urban,Rural
28073,"Lamar, Mississippi",127.9,63597,31419,32178,Urban,Rural
28075,"Lauderdale, Mississippi",104.9,73839,38192,35647,Urban,Rural
28077,"Lawrence, Mississippi",29.2,12590,0,12590,Rural,Rural
28079,"Leake, Mississippi",39.1,22782,4302,18480,Rural,Rural
28081,"Lee, Mississippi",190.2,85569,46405,39164,Urban,Rural
28083,"Leflore, Mississippi",47.4,28111,23292,4819,Rural,Rural
28085,"Lincoln, Mississippi",58.3,34179,10319,23860,Rural,Rural
28087,"Lowndes, Mississippi",115.9,58569,33466,25103,Urban,Rural
28089,"Madison, Mississippi",149.4,106739,76636,30103,Urban,Rural
28091,"Marion, Mississippi",45.2,24533,6661,17872,Rural,Rural
28093,"Marshall, Mississippi",50.0,35333,5902,29431,Rural,Rural
28095,"Monroe, Mississippi",46.1,35241,10713,24528,Rural,Rural
28097,"Montgomery, Mississippi",24.0,9748,3902,5846,Rural,Rural
28099,"Neshoba, Mississippi",51.0,29072,7586,21486,Rural,Rural
28101,"Newton, Mississippi",36.3,20977,2706,18271,Rural,Rural
28103,"Noxubee, Mississippi",14.9,10372,2722,7650,Rural,Rural
28105,"Oktibbeha, Mississippi",108.7,49801,31557,18244,Rural,Rural
28107,"Panola, Mississippi",49.9,34208,7157,27051,Rural,Rural
28109,"Pearl River, Mississippi",68.8,55767,16732,39035,Urban,Rural
28111,"Perry, Mississippi",18.5,11992,0,11992,Rural,Rural
28113,"Pike, Mississippi",96.2,39360,15980,23380,Rural,Rural
28115,"Pontotoc, Mississippi",64.8,32248,5137,27111,Rural,Rural
28117,"Prentiss, Mississippi",60.8,25235,5960,19275,Rural,Rural
28119,"Quitman, Mississippi",16.7,6750,2892,3858,Rural,Rural
28121,"Rankin, Mississippi",200.6,155562,102802,52760,Urban,Rural
28123,"Scott, Mississippi",46.0,28048,7794,20254,Rural,Rural
28125,"Sharkey, Mississippi",10.0,4306,0,4306,Rural,Rural
28127,"Simpson, Mississippi",45.3,26667,4083,22584,Rural,Rural
28129,"Smith, Mississippi",25.0,15911,0,15911,Rural,Rural
28131,"Stone, Mississippi",41.6,18548,3912,14636,Rural,Rural
28133,"Sunflower, Mississippi",35.3,24623,13299,11324,Rural,Rural
28135,"Tallahatchie, Mississippi",21.4,13785,2552,11233,Rural,Rural
28137,"Tate, Mississippi",70.3,28445,6345,22100,Rural,Rural
28139,"Tippah, Mississippi",48.1,22043,3559,18484,Rural,Rural
28141,"Tishomingo, Mississippi",45.8,19441,0,19441,Rural,Rural
28143,"Tunica, Mississippi",21.1,9588,3219,6369,Rural,Rural
28145,"Union, Mississippi",69.5,28887,6989,21898,Rural,Rural
28147,"Walthall, Mississippi",35.4,14288,0,14288,Rural,Rural
28149,"Warren, Mississippi",77.0,45287,26698,18589,Rural,Rural
28151,"Washington, Mississippi",60.1,43570,35936,7634,Rural,Rural
28153,"Wayne, Mississippi",24.9,20179,4097,16082,Rural,Rural
28155,"Webster, Mississippi",23.1,9713,0,9713,Rural,Rural
28157,"Wilkinson, Mississippi",12.7,8613,0,8613,Rural,Rural
28159,"Winston, Mississippi",29.6,17953,4311,13642,Rural,Rural
28161,"Yalobusha, Mississippi",25.9,12107,2494,9613,Rural,Rural
28163,"Yazoo, Mississippi",32.1,29636,17465,12171,Rural,Rural
29001,"Adair, Missouri",44.6,25278,15743,9535,Rural,Rural
29003,"Andrew, Missouri",41.1,17771,6857,10914,Rural,Rural
29005,"Atchison, Missouri",9.4,5143,0,5143,Rural,Rural
29007,"Audrain, Missouri",36.7,25393,14962,10431,Rural,Rural
29009,"Barry, Missouri",46.2,35938,9553,26385,Rural,Rural
29011,"Barton, Missouri",19.9,11769,4269,7500,Rural,Rural
29013,"Bates, Missouri",19.4,16194,3684,12510,Rural,Rural
29015,"Benton, Missouri",27.8,19564,2625,16939,Rural,Rural
29017,"Bollinger, Missouri",19.6,12127,0,12127,Rural,Rural
29019,"Boone, Missouri",264.2,181054,146874,34180,Urban,Rural
29021,"Buchanan, Missouri",214.0,87334,75560,11774,Urban,Rural
29023,"Butler, Missouri",61.3,42597,20389,22208,Rural,Rural
29025,"Caldwell, Missouri",21.2,9047,0,9047,Rural,Rural
29027,"Callaway, Missouri",53.6,44733,16824,27909,Rural,Rural
29029,"Camden, Missouri",70.9,46511,12083,34428,Rural,Rural
29031,"Cape Girardeau, Missouri",136.7,79067,54876,24191,Urban,Rural
29033,"Carroll, Missouri",12.5,8693,3095,5598,Rural,Rural
29035,"Carter, Missouri",11.7,5959,0,5959,Rural,Rural
29037,"Cass, Missouri",152.6,106355,71838,34517,Urban,Rural
29039,"Cedar, Missouri",30.4,14434,3534,10900,Rural,Rural
29041,"Chariton, Missouri",9.9,7434,0,7434,Rural,Rural
29043,"Christian, Missouri",158.4,89131,49178,39953,Urban,Rural
29045,"Clark, Missouri",13.5,6818,0,6818,Rural,Rural
29047,"Clay, Missouri",632.7,251367,226525,24842,Urban,Urban
29049,"Clinton, Missouri",48.7,20421,4880,15541,Rural,Rural
29051,"Cole, Missouri",195.2,76845,54446,22399,Urban,Rural
29053,"Cooper, Missouri",31.4,17725,8288,9437,Rural,Rural
29055,"Crawford, Missouri",32.2,23941,6444,17497,Rural,Rural
29057,"Dade, Missouri",15.5,7583,0,7583,Rural,Rural
29059,"Dallas, Missouri",31.3,16938,3066,13872,Rural,Rural
29061,"Daviess, Missouri",14.7,8263,0,8263,Rural,Rural
29063,"Dekalb, Missouri",29.9,12609,4727,7882,Rural,Rural
29065,"Dent, Missouri",20.7,15583,4888,10695,Rural,Rural
29067,"Douglas, Missouri",16.2,13210,2772,10438,Rural,Rural
29069,"Dunklin, Missouri",53.6,29020,14417,14603,Rural,Rural
29071,"Franklin, Missouri",113.0,104241,46218,58023,Urban,Rural
29073,"Gasconade, Missouri",28.5,14756,2819,11937,Rural,Rural
29075,"Gentry, Missouri",13.4,6584,0,6584,Rural,Rural
29077,"Greene, Missouri",435.7,294249,252938,41311,Urban,Rural
29079,"Grundy, Missouri",22.5,9808,5355,4453,Rural,Rural
29081,"Harrison, Missouri",11.6,8352,2484,5868,Rural,Rural
29083,"Henry, Missouri",31.4,21895,11070,10825,Rural,Rural
29085,"Hickory, Missouri",24.1,9613,0,9613,Rural,Rural
29087,"Holt, Missouri",9.5,4406,0,4406,Rural,Rural
29089,"Howard, Missouri",21.6,10029,3602,6427,Rural,Rural
29091,"Howell, Missouri",43.3,40182,11136,29046,Rural,Rural
29093,"Iron, Missouri",18.4,10144,2521,7623,Rural,Rural
29095,"Jackson, Missouri",1164.7,704043,676890,27153,Urban,Urban
29097,"Jasper, Missouri",190.6,121694,92762,28932,Urban,Rural
29099,"Jefferson, Missouri",343.5,225564,157552,68012,Urban,Rural
29101,"Johnson, Missouri",65.3,54125,26762,27363,Urban,Rural
29103,"Knox, Missouri",7.9,3964,0,3964,Rural,Rural
29105,"Laclede, Missouri",46.8,35808,14182,21626,Rural,Rural
29107,"Lafayette, Missouri",52.2,32813,14135,18678,Rural,Rural
29109,"Lawrence, Missouri",62.9,38474,15886,22588,Rural,Rural
29111,"Lewis, Missouri",19.3,9762,0,9762,Rural,Rural
29113,"Lincoln, Missouri",95.0,59525,14847,44678,Urban,Rural
29115,"Linn, Missouri",19.4,11914,3953,7961,Rural,Rural
29117,"Livingston, Missouri",28.7,15277,9605,5672,Rural,Rural
29119,"Mcdonald, Missouri",42.4,22872,2,22870,Rural,Rural
29121,"Macon, Missouri",18.9,15121,4878,10243,Rural,Rural
29123,"Madison, Missouri",24.5,12109,4201,7908,Rural,Rural
29125,"Maries, Missouri",16.5,8707,0,8707,Rural,Rural
29127,"Marion, Missouri",65.4,28568,21512,7056,Rural,Rural
29129,"Mercer, Missouri",8.0,3621,0,3621,Rural,Rural
29131,"Miller, Missouri",43.4,25729,5198,20531,Rural,Rural
29133,"Mississippi, Missouri",31.9,13128,8833,4295,Rural,Rural
29135,"Moniteau, Missouri",38.9,16139,7634,8505,Rural,Rural
29137,"Monroe, Missouri",13.4,8664,0,8664,Rural,Rural
29139,"Montgomery, Missouri",21.6,11607,2494,9113,Rural,Rural
29141,"Morgan, Missouri",34.6,20699,0,20699,Rural,Rural
29143,"New Madrid, Missouri",25.2,17036,7377,9659,Rural,Rural
29145,"Newton, Missouri",93.4,58379,20683,37696,Urban,Rural
29147,"Nodaway, Missouri",25.2,22111,12619,9492,Rural,Rural
29149,"Oregon, Missouri",13.4,10544,2046,8498,Rural,Rural
29151,"Osage, Missouri",22.6,13655,0,13655,Rural,Rural
29153,"Ozark, Missouri",12.3,9172,0,9172,Rural,Rural
29155,"Pemiscot, Missouri",31.8,15677,7992,7685,Rural,Rural
29157,"Perry, Missouri",40.3,19115,8507,10608,Rural,Rural
29159,"Pettis, Missouri",62.1,42397,26354,16043,Rural,Rural
29161,"Phelps, Missouri",66.4,44628,24092,20536,Rural,Rural
29163,"Pike, Missouri",27.3,18318,8428,9890,Rural,Rural
29165,"Platte, Missouri",249.9,105025,88606,16419,Urban,Rural
29167,"Polk, Missouri",50.8,32287,10013,22274,Rural,Rural
29169,"Pulaski, Missouri",96.1,52603,29347,23256,Urban,Rural
29171,"Putnam, Missouri",9.1,4697,0,4697,Rural,Rural
29173,"Ralls, Missouri",22.0,10319,401,9918,Rural,Rural
29175,"Randolph, Missouri",51.2,24732,13520,11212,Rural,Rural
29177,"Ray, Missouri",40.6,23069,5709,17360,Rural,Rural
29179,"Reynolds, Missouri",7.8,6283,0,6283,Rural,Rural
29181,"Ripley, Missouri",21.1,13271,0,13271,Rural,Rural
29183,"St Charles, Missouri",720.4,403742,380085,23657,Urban,Urban
29185,"St Clair, Missouri",14.1,9432,0,9432,Rural,Rural
29186,"Ste Genevieve, Missouri",36.0,17948,4251,13697,Rural,Rural
29187,"St Francois, Missouri",149.3,67449,40597,26852,Urban,Rural
29189,"St Louis, Missouri",1959.9,995221,983840,11381,Urban,Urban
29195,"Saline, Missouri",30.1,22725,12319,10406,Rural,Rural
29197,"Schuyler, Missouri",15.2,4669,0,4669,Rural,Rural
29199,"Scotland, Missouri",11.2,4912,0,4912,Rural,Rural
29201,"Scott, Missouri",91.1,38256,22325,15931,Rural,Rural
29203,"Shannon, Missouri",8.1,8165,0,8165,Rural,Rural
29205,"Shelby, Missouri",11.9,5940,0,5940,Rural,Rural
29207,"Stoddard, Missouri",35.3,29021,8818,20203,Rural,Rural
29209,"Stone, Missouri",69.2,32092,3634,28458,Rural,Rural
29211,"Sullivan, Missouri",9.4,6064,0,6064,Rural,Rural
29213,"Taney, Missouri",89.0,56286,31462,24824,Urban,Rural
29215,"Texas, Missouri",21.6,25433,199,25234,Rural,Rural
29217,"Vernon, Missouri",24.9,20570,8662,11908,Rural,Rural
29219,"Warren, Missouri",83.7,35864,13353,22511,Rural,Rural
29221,"Washington, Missouri",32.6,24746,4850,19896,Rural,Rural
29223,"Wayne, Missouri",16.9,12852,0,12852,Rural,Rural
29225,"Webster, Missouri",67.0,39714,10418,29296,Rural,Rural
29227,"Worth, Missouri",7.6,2016,0,2016,Rural,Rural
29229,"Wright, Missouri",27.0,18393,4260,14133,Rural,Rural
29510,"St Louis City, Missouri",4823.9,298643,298642,1,Urban,Urban
30001,"Beaverhead, Montana",1.7,9466,4673,4793,Rural,Rural
30003,"Big Horn, Montana",2.6,13231,3764,9467,Rural,Rural
30005,"Blaine, Montana",1.6,6682,0,6682,Rural,Rural
30007,"Broadwater, Montana",5.3,6304,0,6304,Rural,Rural
30009,"Carbon, Montana",5.3,10768,0,10768,Rural,Rural
30011,"Carter, Montana",0.4,1263,0,1263,Rural,Rural
30013,"Cascade, Montana",30.2,81399,65261,16138,Urban,Rural
30015,"Chouteau, Montana",1.4,5642,0,5642,Rural,Rural
30017,"Custer, Montana",3.0,11388,9334,2054,Rural,Rural
30019,"Daniels, Montana",1.2,1694,0,1694,Rural,Rural
30021,"Dawson, Montana",3.6,8566,6195,2371,Rural,Rural
30023,"Deer Lodge, Montana",12.5,9181,6064,3117,Rural,Rural
30025,"Fallon, Montana",1.7,2824,0,2824,Rural,Rural
30027,"Fergus, Montana",2.5,11044,5817,5227,Rural,Rural
30029,"Flathead, Montana",20.6,104638,50686,53952,Urban,Rural
30031,"Gallatin, Montana",44.4,115484,76453,39031,Urban,Rural
30033,"Garfield, Montana",0.3,1260,0,1260,Rural,Rural
30035,"Glacier, Montana",4.6,13707,7696,6011,Rural,Rural
30037,"Golden Valley, Montana",0.7,823,0,823,Rural,Rural
30039,"Granite, Montana",2.0,3405,0,3405,Rural,Rural
30041,"Hill, Montana",5.7,16497,9876,6621,Rural,Rural
30043,"Jefferson, Montana",7.4,12296,0,12296,Rural,Rural
30045,"Judith Basin, Montana",1.1,2020,0,2020,Rural,Rural
30047,"Lake, Montana",20.5,30557,5089,25468,Rural,Rural
30049,"Lewis And Clark, Montana",20.2,69852,49509,20343,Urban,Rural
30051,"Liberty, Montana",1.6,2339,0,2339,Rural,Rural
30053,"Lincoln, Montana",5.6,20110,4011,16099,Rural,Rural
30055,"Mccone, Montana",0.6,1661,0,1661,Rural,Rural
30057,"Madison, Montana",2.4,8726,0,8726,Rural,Rural
30059,"Meagher, Montana",0.8,1872,0,1872,Rural,Rural
30061,"Mineral, Montana",3.6,4440,0,4440,Rural,Rural
30063,"Missoula, Montana",46.3,120074,93043,27031,Urban,Rural
30065,"Musselshell, Montana",2.5,4653,0,4653,Rural,Rural
30067,"Park, Montana",6.0,16709,8734,7975,Rural,Rural
30069,"Petroleum, Montana",0.3,489,0,489,Rural,Rural
30071,"Phillips, Montana",0.8,3946,0,3946,Rural,Rural
30073,"Pondera, Montana",3.6,5895,2460,3435,Rural,Rural
30075,"Powder River, Montana",0.5,1672,0,1672,Rural,Rural
30077,"Powell, Montana",3.0,6945,3070,3875,Rural,Rural
30079,"Prairie, Montana",0.6,1078,0,1078,Rural,Rural
30081,"Ravalli, Montana",18.5,44129,6819,37310,Rural,Rural
30083,"Richland, Montana",5.2,10780,6040,4740,Rural,Rural
30085,"Roosevelt, Montana",4.7,10988,6599,4389,Rural,Rural
30087,"Rosebud, Montana",1.8,8902,0,8902,Rural,Rural
30089,"Sanders, Montana",4.4,12209,0,12209,Rural,Rural
30091,"Sheridan, Montana",2.0,3297,0,3297,Rural,Rural
30093,"Silver Bow, Montana",48.8,35052,31005,4047,Rural,Rural
30095,"Stillwater, Montana",5.4,9711,0,9711,Rural,Rural
30097,"Sweet Grass, Montana",2.0,3757,0,3757,Rural,Rural
30099,"Teton, Montana",2.7,6171,0,6171,Rural,Rural
30101,"Toole, Montana",2.5,4721,2669,2052,Rural,Rural
30103,"Treasure, Montana",0.7,701,0,701,Rural,Rural
30105,"Valley, Montana",1.5,7401,3320,4081,Rural,Rural
30107,"Wheatland, Montana",1.5,2140,0,2140,Rural,Rural
30109,"Wibaux, Montana",1.1,966,0,966,Rural,Rural
30111,"Yellowstone, Montana",61.5,161935,134627,27308,Urban,Rural
31001,"Adams, Nebraska",55.5,31243,24237,7006,Rural,Rural
31003,"Antelope, Nebraska",7.3,6297,0,6297,Rural,Rural
31005,"Arthur, Nebraska",0.7,467,0,467,Rural,Rural
31007,"Banner, Nebraska",1.0,752,0,752,Rural,Rural
31009,"Blaine, Nebraska",0.7,464,0,464,Rural,Rural
31011,"Boone, Nebraska",7.6,5185,0,5185,Rural,Rural
31013,"Box Butte, Nebraska",10.0,10774,8093,2681,Rural,Rural
31015,"Boyd, Nebraska",3.6,1923,0,1923,Rural,Rural
31017,"Brown, Nebraska",2.4,2963,0,2963,Rural,Rural
31019,"Buffalo, Nebraska",51.5,49819,33754,16065,Rural,Rural
31021,"Burt, Nebraska",13.2,6476,0,6476,Rural,Rural
31023,"Butler, Nebraska",13.7,8037,2763,5274,Rural,Rural
31025,"Cass, Nebraska",47.2,26338,7063,19275,Rural,Rural
31027,"Cedar, Nebraska",11.3,8397,0,8397,Rural,Rural
31029,"Chase, Nebraska",4.4,3941,0,3941,Rural,Rural
31031,"Cherry, Nebraska",1.0,5687,2630,3057,Rural,Rural
31033,"Cheyenne, Nebraska",7.4,8812,5592,3220,Rural,Rural
31035,"Clay, Nebraska",10.9,6213,0,6213,Rural,Rural
31037,"Colfax, Nebraska",25.9,10656,6350,4306,Rural,Rural
31039,"Cuming, Nebraska",15.5,8848,3070,5778,Rural,Rural
31041,"Custer, Nebraska",4.2,10790,3445,7345,Rural,Rural
31043,"Dakota, Nebraska",75.7,20007,15787,4220,Rural,Rural
31045,"Dawes, Nebraska",6.1,8548,5126,3422,Rural,Rural
31047,"Dawson, Nebraska",23.2,23508,17251,6257,Rural,Rural
31049,"Deuel, Nebraska",4.1,1819,0,1819,Rural,Rural
31051,"Dixon, Nebraska",11.8,5623,0,5623,Rural,Rural
31053,"Dodge, Nebraska",69.2,36585,27436,9149,Rural,Rural
31055,"Douglas, Nebraska",1742.0,572163,559550,12613,Urban,Urban
31057,"Dundy, Nebraska",1.8,1689,0,1689,Rural,Rural
31059,"Fillmore, Nebraska",9.5,5460,0,5460,Rural,Rural
31061,"Franklin, Nebraska",5.2,2978,0,2978,Rural,Rural
31063,"Frontier, Nebraska",2.7,2627,0,2627,Rural,Rural
31065,"Furnas, Nebraska",6.5,4667,0,4667,Rural,Rural
31067,"Gage, Nebraska",25.3,21546,11981,9565,Rural,Rural
31069,"Garden, Nebraska",1.1,1835,0,1835,Rural,Rural
31071,"Garfield, Nebraska",3.5,1979,0,1979,Rural,Rural
31073,"Gosper, Nebraska",4.3,1985,0,1985,Rural,Rural
31075,"Grant, Nebraska",0.8,619,0,619,Rural,Rural
31077,"Greeley, Nebraska",4.1,2356,0,2356,Rural,Rural
31079,"Hall, Nebraska",112.3,61373,52377,8996,Urban,Rural
31081,"Hamilton, Nebraska",17.2,9364,4554,4810,Rural,Rural
31083,"Harlan, Nebraska",6.1,3390,0,3390,Rural,Rural
31085,"Hayes, Nebraska",1.3,922,0,922,Rural,Rural
31087,"Hitchcock, Nebraska",3.9,2767,0,2767,Rural,Rural
31089,"Holt, Nebraska",4.2,10063,3555,6508,Rural,Rural
31091,"Hooker, Nebraska",1.0,689,0,689,Rural,Rural
31093,"Howard, Nebraska",11.4,6467,0,6467,Rural,Rural
31095,"Jefferson, Nebraska",12.4,7042,3629,3413,Rural,Rural
31097,"Johnson, Nebraska",13.5,5083,0,5083,Rural,Rural
31099,"Kearney, Nebraska",12.6,6503,2935,3568,Rural,Rural
31101,"Keith, Nebraska",7.6,8031,4224,3807,Rural,Rural
31103,"Keya Paha, Nebraska",1.0,811,0,811,Rural,Rural
31105,"Kimball, Nebraska",3.8,3656,0,3656,Rural,Rural
31107,"Knox, Nebraska",7.5,8339,0,8339,Rural,Rural
31109,"Lancaster, Nebraska",382.4,320285,293311,26974,Urban,Rural
31111,"Lincoln, Nebraska",13.6,34915,24219,10696,Rural,Rural
31113,"Logan, Nebraska",1.3,743,0,743,Rural,Rural
31115,"Loup, Nebraska",1.2,671,0,671,Rural,Rural
31117,"Mcpherson, Nebraska",0.6,493,0,493,Rural,Rural
31119,"Madison, Nebraska",61.4,35160,25376,9784,Rural,Rural
31121,"Merrick, Nebraska",16.0,7753,3194,4559,Rural,Rural
31123,"Morrill, Nebraska",3.2,4623,0,4623,Rural,Rural
31125,"Nance, Nebraska",8.0,3527,0,3527,Rural,Rural
31127,"Nemaha, Nebraska",17.1,6968,3333,3635,Rural,Rural
31129,"Nuckolls, Nebraska",7.2,4138,0,4138,Rural,Rural
31131,"Otoe, Nebraska",26.0,16034,7146,8888,Rural,Rural
31133,"Pawnee, Nebraska",6.1,2618,0,2618,Rural,Rural
31135,"Perkins, Nebraska",3.3,2897,0,2897,Rural,Rural
31137,"Phelps, Nebraska",16.7,9034,5239,3795,Rural,Rural
31139,"Pierce, Nebraska",12.5,7166,0,7166,Rural,Rural
31141,"Platte, Nebraska",49.7,33479,22922,10557,Rural,Rural
31143,"Polk, Nebraska",11.9,5220,0,5220,Rural,Rural
31145,"Red Willow, Nebraska",15.0,10725,7339,3386,Rural,Rural
31147,"Richardson, Nebraska",14.3,7870,3898,3972,Rural,Rural
31149,"Rock, Nebraska",1.3,1354,0,1354,Rural,Rural
31151,"Saline, Nebraska",24.7,14188,6905,7283,Rural,Rural
31153,"Sarpy, Nebraska",787.2,188134,178174,9960,Urban,Urban
31155,"Saunders, Nebraska",28.9,21699,7280,14419,Rural,Rural
31157,"Scotts Bluff, Nebraska",48.1,35583,24964,10619,Rural,Rural
31159,"Seward, Nebraska",30.3,17336,6788,10548,Rural,Rural
31161,"Sheridan, Nebraska",2.2,5256,0,5256,Rural,Rural
31163,"Sherman, Nebraska",5.3,2999,0,2999,Rural,Rural
31165,"Sioux, Nebraska",0.6,1160,0,1160,Rural,Rural
31167,"Stanton, Nebraska",13.8,5901,1555,4346,Rural,Rural
31169,"Thayer, Nebraska",8.7,5000,0,5000,Rural,Rural
31171,"Thomas, Nebraska",1.0,724,0,724,Rural,Rural
31173,"Thurston, Nebraska",18.4,7231,0,7231,Rural,Rural
31175,"Valley, Nebraska",7.3,4149,0,4149,Rural,Rural
31177,"Washington, Nebraska",53.5,20880,7843,13037,Rural,Rural
31179,"Wayne, Nebraska",21.4,9468,5381,4087,Rural,Rural
31181,"Webster, Nebraska",6.1,3494,0,3494,Rural,Rural
31183,"Wheeler, Nebraska",1.4,781,0,781,Rural,Rural
31185,"York, Nebraska",23.9,13694,7621,6073,Rural,Rural
32001,"Churchill, Nevada",5.1,25044,16426,8618,Rural,Rural
32003,"Clark, Nevada",289.6,2285328,2256102,29226,Urban,Rural
32005,"Douglas, Nevada",69.4,49225,33638,15587,Rural,Rural
32007,"Elko, Nevada",3.1,52804,32802,20002,Urban,Rural
32009,"Esmeralda, Nevada",0.2,875,0,875,Rural,Rural
32011,"Eureka, Nevada",0.5,2043,0,2043,Rural,Rural
32013,"Humboldt, Nevada",1.7,16841,10481,6360,Rural,Rural
32015,"Lander, Nevada",1.0,5520,3354,2166,Rural,Rural
32017,"Lincoln, Nevada",0.5,5183,0,5183,Rural,Rural
32019,"Lyon, Nevada",29.1,58186,36654,21532,Urban,Rural
32021,"Mineral, Nevada",1.2,4531,3077,1454,Rural,Rural
32023,"Nye, Nevada",2.6,47174,30408,16766,Rural,Rural
32027,"Pershing, Nevada",1.1,6770,0,6770,Rural,Rural
32029,"Storey, Nevada",15.9,4173,308,3865,Rural,Rural
32031,"Washoe, Nevada",75.4,475286,454851,20435,Urban,Rural
32033,"White Pine, Nevada",1.1,9543,4375,5168,Rural,Rural
32510,"Carson City, Nevada",389.5,56347,53650,2697,Urban,Rural
33001,"Belknap, New Hampshire",153.7,61528,20708,40820,Urban,Rural
33003,"Carroll, New Hampshire",52.9,49228,4822,44406,Rural,Rural
33005,"Cheshire, New Hampshire",108.1,76422,26614,49808,Urban,Rural
33007,"Coos, New Hampshire",17.7,31691,10937,20754,Rural,Rural
33009,"Grafton, New Hampshire",52.7,90008,27990,62018,Urban,Rural
33011,"Hillsborough, New Hampshire",476.6,417553,328517,89036,Urban,Rural
33013,"Merrimack, New Hampshire",162.6,151915,68780,83135,Urban,Rural
33015,"Rockingham, New Hampshire",447.6,310982,233296,77686,Urban,Rural
33017,"Strafford, New Hampshire",354.7,130860,88533,42327,Urban,Rural
33019,"Sullivan, New Hampshire",80.5,43259,15470,27789,Rural,Rural
34001,"Atlantic, New Jersey",475.9,264448,231044,33404,Urban,Rural
34003,"Bergen, New Jersey",4014.4,935393,934456,937,Urban,Urban
34005,"Burlington, New Jersey",559.0,446432,416719,29713,Urban,Urban
34007,"Camden, New Jersey",2292.7,507282,498998,8284,Urban,Urban
34009,"Cape May, New Jersey",366.8,92211,76103,16108,Urban,Rural
34011,"Cumberland, New Jersey",308.8,149350,115446,33904,Urban,Rural
34013,"Essex, New Jersey",6338.1,799943,799826,117,Urban,Urban
34015,"Gloucester, New Jersey",908.1,292421,268071,24350,Urban,Urban
34017,"Hudson, New Jersey",14566.3,672831,672831,0,Urban,Urban
34019,"Hunterdon, New Jersey",291.0,124506,62810,61696,Urban,Rural
34021,"Mercer, New Jersey",1639.4,368145,355451,12694,Urban,Urban
34023,"Middlesex, New Jersey",2676.3,826735,821190,5545,Urban,Urban
34025,"Monmouth, New Jersey",1322.5,619973,596886,23087,Urban,Urban
34027,"Morris, New Jersey",1071.2,492937,459518,33419,Urban,Urban
34029,"Ocean, New Jersey",970.9,610498,592778,17720,Urban,Urban
34031,"Passaic, New Jersey",2716.4,501429,489243,12186,Urban,Urban
34033,"Salem, New Jersey",187.9,62367,34186,28181,Urban,Rural
34035,"Somerset, New Jersey",1093.3,329964,310878,19086,Urban,Urban
34037,"Sussex, New Jersey",271.0,140677,84662,56015,Urban,Rural
34039,"Union, New Jersey",5417.7,557237,557237,0,Urban,Urban
34041,"Warren, New Jersey",295.6,105503,65940,39563,Urban,Rural
35001,"Bernalillo, New Mexico",585.9,680099,651382,28717,Urban,Urban
35003,"Catron, New Mexico",0.5,3547,0,3547,Rural,Rural
35005,"Chaves, New Mexico",10.6,64554,48878,15676,Urban,Rural
35006,"Cibola, New Mexico",5.9,26641,11926,14715,Rural,Rural
35007,"Colfax, New Mexico",3.2,11933,5656,6277,Rural,Rural
35009,"Curry, New Mexico",34.7,48765,41989,6776,Rural,Rural
35011,"De Baca, New Mexico",0.8,1745,0,1745,Rural,Rural
35013,"Dona Ana, New Mexico",57.4,218700,176596,42104,Urban,Rural
35015,"Eddy, New Mexico",14.0,58630,46414,12216,Urban,Rural
35017,"Grant, New Mexico",6.8,26971,15506,11465,Rural,Rural
35019,"Guadalupe, New Mexico",1.4,4298,2396,1902,Rural,Rural
35021,"Harding, New Mexico",0.3,621,0,621,Rural,Rural
35023,"Hidalgo, New Mexico",1.2,4193,0,4193,Rural,Rural
35025,"Lea, New Mexico",16.2,71104,56216,14888,Urban,Rural
35027,"Lincoln, New Mexico",4.1,19639,9190,10449,Rural,Rural
35028,"Los Alamos, New Mexico",178.8,19514,17322,2192,Rural,Rural
35029,"Luna, New Mexico",8.0,23697,14020,9677,Rural,Rural
35031,"Mckinley, New Mexico",13.1,71446,30373,41073,Urban,Rural
35033,"Mora, New Mexico",2.3,4530,0,4530,Rural,Rural
35035,"Otero, New Mexico",10.2,67603,47629,19974,Urban,Rural
35037,"Quay, New Mexico",2.9,8248,4809,3439,Rural,Rural
35039,"Rio Arriba, New Mexico",6.6,38954,19583,19371,Rural,Rural
35041,"Roosevelt, New Mexico",7.5,18414,11656,6758,Rural,Rural
35043,"Sandoval, New Mexico",39.8,147724,122711,25013,Urban,Rural
35045,"San Juan, New Mexico",22.3,122909,81561,41348,Urban,Rural
35047,"San Miguel, New Mexico",5.8,27258,14482,12776,Rural,Rural
35049,"Santa Fe, New Mexico",79.0,150930,112947,37983,Urban,Rural
35051,"Sierra, New Mexico",2.6,10835,7122,3713,Rural,Rural
35053,"Socorro, New Mexico",2.5,16588,8431,8157,Rural,Rural
35055,"Taos, New Mexico",14.9,32827,13677,19150,Rural,Rural
35057,"Torrance, New Mexico",4.6,15491,186,15305,Rural,Rural
35059,"Union, New Mexico",1.1,4056,0,4056,Rural,Rural
35061,"Valencia, New Mexico",72.2,76940,64184,12756,Urban,Rural
36001,"Albany, New York",585.0,305817,276068,29749,Urban,Urban
36003,"Allegany, New York",44.8,46118,9771,36347,Rural,Rural
36005,"Bronx, New York",33597.3,1414324,1414284,40,Urban,Urban
36007,"Broome, New York",269.6,190269,141045,49224,Urban,Rural
36009,"Cattaraugus, New York",58.2,76112,29135,46977,Urban,Rural
36011,"Cayuga, New York",110.7,76524,33810,42714,Urban,Rural
36013,"Chautauqua, New York",119.9,127072,71392,55680,Urban,Rural
36015,"Chemung, New York",204.9,83466,63065,20401,Urban,Rural
36017,"Chenango, New York",52.9,47229,7794,39435,Rural,Rural
36019,"Clinton, New York",77.6,80569,28765,51804,Urban,Rural
36021,"Columbia, New York",93.8,59510,15873,43637,Urban,Rural
36023,"Cortland, New York",95.5,47629,26768,20861,Rural,Rural
36025,"Delaware, New York",30.6,44120,9451,34669,Rural,Rural
36027,"Dutchess, New York",370.5,294812,219765,75047,Urban,Rural
36029,"Erie, New York",882.5,920134,833888,86246,Urban,Urban
36031,"Essex, New York",20.6,36913,9111,27802,Rural,Rural
36033,"Franklin, New York",30.7,50088,18574,31514,Urban,Rural
36035,"Fulton, New York",107.8,53413,26492,26921,Urban,Rural
36037,"Genesee, New York",116.3,57343,23060,34283,Urban,Rural
36039,"Greene, New York",73.0,47232,12555,34677,Rural,Rural
36041,"Hamilton, New York",2.6,4418,0,4418,Rural,Rural
36043,"Herkimer, New York",43.5,61360,29506,31854,Urban,Rural
36045,"Jefferson, New York",86.2,109309,56786,52523,Urban,Rural
36047,"Kings, New York",36095.7,2556145,2556106,39,Urban,Urban
36049,"Lewis, New York",20.6,26255,3492,22763,Rural,Rural
36051,"Livingston, New York",99.7,62962,28727,34235,Urban,Rural
36053,"Madison, New York",108.3,70899,29156,41743,Urban,Rural
36055,"Monroe, New York",1129.6,742374,694279,48095,Urban,Urban
36057,"Montgomery, New York",122.3,49299,29214,20085,Rural,Rural
36059,"Nassau, New York",4771.8,1358613,1355999,2614,Urban,Urban
36061,"New York, New York",71389.7,1629734,1629734,0,Urban,Urban
36063,"Niagara, New York",401.4,209653,162471,47182,Urban,Rural
36065,"Oneida, New York",188.7,228726,153374,75352,Urban,Rural
36067,"Onondaga, New York",592.0,460793,402625,58168,Urban,Urban
36069,"Ontario, New York",171.0,110132,57810,52322,Urban,Rural
36071,"Orange, New York",475.3,385834,299490,86344,Urban,Rural
36073,"Orleans, New York",103.0,40309,15786,24523,Rural,Rural
36075,"Oswego, New York",123.2,117203,44525,72678,Urban,Rural
36077,"Otsego, New York",59.4,59549,17606,41943,Urban,Rural
36079,"Putnam, New York",427.3,98405,78182,20223,Urban,Rural
36081,"Queens, New York",20747.5,2251771,2251771,0,Urban,Urban
36083,"Rensselaer, New York",243.6,158904,110369,48535,Urban,Rural
36085,"Richmond, New York",8172.4,477025,477025,0,Urban,Urban
36087,"Rockland, New York",1879.5,326189,323854,2335,Urban,Urban
36089,"St Lawrence, New York",40.2,107699,41073,66626,Urban,Rural
36091,"Saratoga, New York",284.6,230555,161053,69502,Urban,Rural
36093,"Schenectady, New York",760.7,155578,142857,12721,Urban,Urban
36095,"Schoharie, New York",49.9,31021,5182,25839,Rural,Rural
36097,"Schuyler, New York",54.4,17846,3352,14494,Rural,Rural
36099,"Seneca, New York",105.2,34064,14096,19968,Rural,Rural
36101,"Steuben, New York",68.5,95301,37928,57373,Urban,Rural
36103,"Suffolk, New York",1620.0,1477528,1439013,38515,Urban,Urban
36105,"Sullivan, New York",78.1,75624,19531,56093,Urban,Rural
36107,"Tioga, New York",93.0,48245,16597,31648,Rural,Rural
36109,"Tompkins, New York",215.7,102377,57940,44437,Urban,Rural
36111,"Ulster, New York",158.2,177798,95948,81850,Urban,Rural
36113,"Warren, New York",73.9,64057,42326,21731,Urban,Rural
36115,"Washington, New York",73.7,61254,19715,41539,Urban,Rural
36117,"Wayne, New York",148.9,89892,35391,54501,Urban,Rural
36119,"Westchester, New York",2249.1,968247,936767,31480,Urban,Urban
36121,"Wyoming, New York",67.2,39858,14143,25715,Rural,Rural
36123,"Yates, New York",73.5,24867,7191,17676,Rural,Rural
37001,"Alamance, North Carolina",402.3,170548,122085,48463,Urban,Rural
37003,"Alexander, North Carolina",144.8,37646,10367,27279,Rural,Rural
37005,"Alleghany, North Carolina",47.6,11194,0,11194,Rural,Rural
37007,"Anson, North Carolina",46.3,24584,5355,19229,Rural,Rural
37009,"Ashe, North Carolina",64.3,27384,4139,23245,Rural,Rural
37011,"Avery, North Carolina",71.3,17610,2015,15595,Rural,Rural
37013,"Beaufort, North Carolina",57.0,47128,16254,30874,Rural,Rural
37015,"Bertie, North Carolina",27.0,18912,3276,15636,Rural,Rural
37017,"Bladen, North Carolina",37.4,32704,2790,29914,Rural,Rural
37019,"Brunswick, North Carolina",171.3,145089,82761,62328,Urban,Rural
37021,"Buncombe, North Carolina",399.5,262365,199057,63308,Urban,Rural
37023,"Burke, North Carolina",178.8,90648,51954,38694,Urban,Rural
37025,"Cabarrus, North Carolina",602.9,218090,175715,42375,Urban,Urban
37027,"Caldwell, North Carolina",174.7,82384,53934,28450,Urban,Rural
37029,"Camden, North Carolina",45.5,10941,49,10892,Rural,Rural
37031,"Carteret, North Carolina",137.9,69820,46917,22903,Urban,Rural
37033,"Caswell, North Carolina",53.3,22666,184,22482,Rural,Rural
37035,"Catawba, North Carolina",401.3,160021,111468,48553,Urban,Rural
37037,"Chatham, North Carolina",110.3,75255,25660,49595,Urban,Rural
37039,"Cherokee, North Carolina",63.3,28826,0,28826,Rural,Rural
37041,"Chowan, North Carolina",81.0,13965,4522,9443,Rural,Rural
37043,"Clay, North Carolina",52.8,11339,0,11339,Rural,Rural
37045,"Cleveland, North Carolina",211.8,98313,43310,55003,Urban,Rural
37047,"Columbus, North Carolina",59.2,55520,10854,44666,Urban,Rural
37049,"Craven, North Carolina",144.3,102334,74008,28326,Urban,Rural
37051,"Cumberland, North Carolina",513.8,335139,290490,44649,Urban,Urban
37053,"Currituck, North Carolina",107.3,28090,478,27612,Rural,Rural
37055,"Dare, North Carolina",97.0,37174,26382,10792,Rural,Rural
37057,"Davidson, North Carolina",304.7,168374,88333,80041,Urban,Rural
37059,"Davie, North Carolina",163.1,43079,12810,30269,Rural,Rural
37061,"Duplin, North Carolina",71.9,58698,7947,50751,Urban,Rural
37063,"Durham, North Carolina",1127.3,322388,304299,18089,Urban,Urban
37065,"Edgecombe, North Carolina",101.6,51354,27913,23441,Urban,Rural
37067,"Forsyth, North Carolina",940.2,383727,355595,28132,Urban,Urban
37069,"Franklin, North Carolina",143.0,70319,10261,60058,Urban,Rural
37071,"Gaston, North Carolina",634.2,225802,181557,44245,Urban,Urban
37073,"Gates, North Carolina",34.1,11597,0,11597,Rural,Rural
37075,"Graham, North Carolina",29.0,8459,0,8459,Rural,Rural
37077,"Granville, North Carolina",114.4,60836,25682,35154,Urban,Rural
37079,"Greene, North Carolina",79.3,21085,0,21085,Rural,Rural
37081,"Guilford, North Carolina",834.4,538745,470183,68562,Urban,Urban
37083,"Halifax, North Carolina",68.9,49911,22587,27324,Rural,Rural
37085,"Harnett, North Carolina",229.5,136535,59734,76801,Urban,Rural
37087,"Haywood, North Carolina",113.3,62720,27892,34828,Urban,Rural
37089,"Henderson, North Carolina",317.2,118348,78727,39621,Urban,Rural
37091,"Hertford, North Carolina",66.8,23594,7378,16216,Rural,Rural
37093,"Hoke, North Carolina",141.7,55362,31462,23900,Urban,Rural
37095,"Hyde, North Carolina",8.1,4988,0,4988,Rural,Rural
37097,"Iredell, North Carolina",319.0,183058,113613,69445,Urban,Rural
37099,"Jackson, North Carolina",89.7,44012,12085,31927,Rural,Rural
37101,"Johnston, North Carolina",267.4,211601,101413,110188,Urban,Rural
37103,"Jones, North Carolina",20.1,9443,0,9443,Rural,Rural
37105,"Lee, North Carolina",243.4,62060,35496,26564,Urban,Rural
37107,"Lenoir, North Carolina",139.6,55919,30833,25086,Urban,Rural
37109,"Lincoln, North Carolina",291.0,86706,39411,47295,Urban,Rural
37111,"Mcdowell, North Carolina",104.3,45955,13602,32353,Rural,Rural
37113,"Macon, North Carolina",70.1,36140,7189,28951,Rural,Rural
37115,"Madison, North Carolina",48.7,21893,2041,19852,Rural,Rural
37117,"Martin, North Carolina",48.7,22446,4895,17551,Rural,Rural
37119,"Mecklenburg, North Carolina",2126.0,1113690,1101719,11971,Urban,Urban
37121,"Mitchell, North Carolina",67.8,15019,2619,12400,Rural,Rural
37123,"Montgomery, North Carolina",55.5,27282,6234,21048,Rural,Rural
37125,"Moore, North Carolina",145.6,101590,50154,51436,Urban,Rural
37127,"Nash, North Carolina",174.8,94450,49570,44880,Urban,Rural
37129,"New Hanover, North Carolina",1230.6,235705,230477,5228,Urban,Urban
37131,"Northampton, North Carolina",36.2,19447,2070,17377,Rural,Rural
37133,"Onslow, North Carolina",259.3,197802,145580,52222,Urban,Rural
37135,"Orange, North Carolina",373.6,148696,106111,42585,Urban,Rural
37137,"Pamlico, North Carolina",38.0,12791,0,12791,Rural,Rural
37139,"Pasquotank, North Carolina",176.2,39979,23223,16756,Rural,Rural
37141,"Pender, North Carolina",73.1,63617,19985,43632,Urban,Rural
37143,"Perquimans, North Carolina",54.7,13510,0,13510,Rural,Rural
37145,"Person, North Carolina",101.0,39630,9669,29961,Rural,Rural
37147,"Pitt, North Carolina",278.0,181256,135050,46206,Urban,Rural
37149,"Polk, North Carolina",87.6,20826,1594,19232,Rural,Rural
37151,"Randolph, North Carolina",184.1,144037,63024,81013,Urban,Rural
37153,"Richmond, North Carolina",94.7,44875,24448,20427,Rural,Rural
37155,"Robeson, North Carolina",137.4,130397,48795,81602,Urban,Rural
37157,"Rockingham, North Carolina",161.4,91290,34663,56627,Urban,Rural
37159,"Rowan, North Carolina",279.1,142730,87220,55510,Urban,Rural
37161,"Rutherford, North Carolina",119.3,67294,26078,41216,Urban,Rural
37163,"Sampson, North Carolina",67.4,63667,9500,54167,Urban,Rural
37165,"Scotland, North Carolina",109.2,34802,17859,16943,Rural,Rural
37167,"Stanly, North Carolina",159.7,63091,20329,42762,Urban,Rural
37169,"Stokes, North Carolina",101.8,45680,11116,34564,Rural,Rural
37171,"Surry, North Carolina",135.1,71897,22423,49474,Urban,Rural
37173,"Swain, North Carolina",27.1,14335,0,14335,Rural,Rural
37175,"Transylvania, North Carolina",91.5,34620,13885,20735,Rural,Rural
37177,"Tyrrell, North Carolina",10.3,4005,0,4005,Rural,Rural
37179,"Union, North Carolina",382.4,241512,175659,65853,Urban,Rural
37181,"Vance, North Carolina",175.9,44586,20400,24186,Rural,Rural
37183,"Wake, North Carolina",1338.7,1118126,1048940,69186,Urban,Urban
37185,"Warren, North Carolina",46.1,19770,0,19770,Rural,Rural
37187,"Washington, North Carolina",33.3,11580,3738,7842,Rural,Rural
37189,"Watauga, North Carolina",180.6,56449,25024,31425,Urban,Rural
37191,"Wayne, North Carolina",222.9,123306,65782,57524,Urban,Rural
37193,"Wilkes, North Carolina",90.9,68557,18638,49919,Urban,Rural
37195,"Wilson, North Carolina",222.7,82008,50318,31690,Urban,Rural
37197,"Yadkin, North Carolina",112.8,37770,5846,31924,Rural,Rural
37199,"Yancey, North Carolina",58.1,18176,0,18176,Rural,Rural
38001,"Adams, North Dakota",2.2,2206,0,2206,Rural,Rural
38003,"Barnes, North Dakota",7.0,10405,6320,4085,Rural,Rural
38005,"Benson, North Dakota",4.9,6827,0,6827,Rural,Rural
38007,"Billings, North Dakota",0.8,928,0,928,Rural,Rural
38009,"Bottineau, North Dakota",3.8,6263,0,6263,Rural,Rural
38011,"Bowman, North Dakota",2.6,3008,0,3008,Rural,Rural
38013,"Burke, North Dakota",1.9,2106,0,2106,Rural,Rural
38015,"Burleigh, North Dakota",58.8,95997,77942,18055,Urban,Rural
38017,"Cass, North Dakota",103.7,182946,163787,19159,Urban,Rural
38019,"Cavalier, North Dakota",2.5,3762,0,3762,Rural,Rural
38021,"Dickey, North Dakota",4.3,4874,0,4874,Rural,Rural
38023,"Divide, North Dakota",1.8,2261,0,2261,Rural,Rural
38025,"Dunn, North Dakota",2.2,4425,0,4425,Rural,Rural
38027,"Eddy, North Dakota",3.6,2292,0,2292,Rural,Rural
38029,"Emmons, North Dakota",2.1,3245,0,3245,Rural,Rural
38031,"Foster, North Dakota",5.0,3207,0,3207,Rural,Rural
38033,"Golden Valley, North Dakota",1.8,1753,0,1753,Rural,Rural
38035,"Grand Forks, North Dakota",48.2,69247,57457,11790,Urban,Rural
38037,"Grant, North Dakota",1.4,2268,0,2268,Rural,Rural
38039,"Griggs, North Dakota",3.2,2236,0,2236,Rural,Rural
38041,"Hettinger, North Dakota",2.2,2501,0,2501,Rural,Rural
38043,"Kidder, North Dakota",1.8,2478,0,2478,Rural,Rural
38045,"Lamoure, North Dakota",3.5,4034,0,4034,Rural,Rural
38047,"Logan, North Dakota",1.9,1844,0,1844,Rural,Rural
38049,"Mchenry, North Dakota",3.1,5733,0,5733,Rural,Rural
38051,"Mcintosh, North Dakota",2.6,2498,0,2498,Rural,Rural
38053,"Mckenzie, North Dakota",5.6,15330,0,15330,Rural,Rural
38055,"Mclean, North Dakota",4.5,9447,0,9447,Rural,Rural
38057,"Mercer, North Dakota",7.8,8154,2867,5287,Rural,Rural
38059,"Morton, North Dakota",16.3,31469,21528,9941,Rural,Rural
38061,"Mountrail, North Dakota",5.8,10552,0,10552,Rural,Rural
38063,"Nelson, North Dakota",2.9,2879,0,2879,Rural,Rural
38065,"Oliver, North Dakota",2.7,1965,0,1965,Rural,Rural
38067,"Pembina, North Dakota",6.1,6801,0,6801,Rural,Rural
38069,"Pierce, North Dakota",3.9,3966,2587,1379,Rural,Rural
38071,"Ramsey, North Dakota",9.7,11477,7446,4031,Rural,Rural
38073,"Ransom, North Dakota",6.1,5219,0,5219,Rural,Rural
38075,"Renville, North Dakota",2.6,2317,0,2317,Rural,Rural
38077,"Richland, North Dakota",11.3,16164,7706,8458,Rural,Rural
38079,"Rolette, North Dakota",15.6,14096,0,14096,Rural,Rural
38081,"Sargent, North Dakota",4.5,3905,0,3905,Rural,Rural
38083,"Sheridan, North Dakota",1.3,1309,0,1309,Rural,Rural
38085,"Sioux, North Dakota",3.8,4202,0,4202,Rural,Rural
38087,"Slope, North Dakota",0.6,746,0,746,Rural,Rural
38089,"Stark, North Dakota",23.7,31594,22756,8838,Rural,Rural
38091,"Steele, North Dakota",2.7,1893,0,1893,Rural,Rural
38093,"Stutsman, North Dakota",9.3,20701,14923,5778,Rural,Rural
38095,"Towner, North Dakota",2.1,2182,0,2182,Rural,Rural
38097,"Traill, North Dakota",9.3,8057,0,8057,Rural,Rural
38099,"Walsh, North Dakota",8.3,10637,4039,6598,Rural,Rural
38101,"Ward, North Dakota",33.5,67410,52428,14982,Urban,Rural
38103,"Wells, North Dakota",3.0,3834,0,3834,Rural,Rural
38105,"Williams, North Dakota",18.3,37963,25439,12524,Rural,Rural
39001,"Adams, Ohio",47.5,27725,3043,24682,Rural,Rural
39003,"Allen, Ohio",254.1,102294,75775,26519,Urban,Rural
39005,"Ashland, Ohio",126.6,53550,20425,33125,Urban,Rural
39007,"Ashtabula, Ohio",138.6,97260,52361,44899,Urban,Rural
39009,"Athens, Ohio",129.6,65267,37138,28129,Urban,Rural
39011,"Auglaize, Ohio",113.9,45702,27763,17939,Rural,Rural
39013,"Belmont, Ohio",126.0,67029,30324,36705,Urban,Rural
39015,"Brown, Ohio",88.8,43516,10222,33294,Rural,Rural
39017,"Butler, Ohio",822.3,384046,348342,35704,Urban,Urban
39019,"Carroll, Ohio",68.2,26902,7813,19089,Rural,Rural
39021,"Champaign, Ohio",90.9,38950,11330,27620,Rural,Rural
39023,"Clark, Ohio",337.6,134171,102590,31581,Urban,Rural
39025,"Clermont, Ohio",457.9,207021,159913,47108,Urban,Rural
39027,"Clinton, Ohio",102.8,42021,19073,22948,Rural,Rural
39029,"Columbiana, Ohio",191.7,101939,57254,44685,Urban,Rural
39031,"Coshocton, Ohio",65.0,36658,14115,22543,Rural,Rural
39033,"Crawford, Ohio",103.4,41534,26894,14640,Rural,Rural
39035,"Cuyahoga, Ohio",2700.0,1234398,1227200,7198,Urban,Urban
39037,"Darke, Ohio",85.5,51136,17205,33931,Urban,Rural
39039,"Defiance, Ohio",92.7,38122,21429,16693,Rural,Rural
39041,"Delaware, Ohio",474.9,210414,169492,40922,Urban,Rural
39043,"Erie, Ohio",295.6,74370,54781,19589,Urban,Rural
39045,"Fairfield, Ohio",313.6,158181,103158,55023,Urban,Rural
39047,"Fayette, Ohio",70.3,28561,14974,13587,Rural,Rural
39049,"Franklin, Ohio",2479.2,1319380,1301369,18011,Urban,Urban
39051,"Fulton, Ohio",104.0,42167,18441,23726,Rural,Rural
39053,"Gallia, Ohio",64.1,29909,5581,24328,Rural,Rural
39055,"Geauga, Ohio",234.3,93749,33852,59897,Urban,Rural
39057,"Greene, Ohio",410.2,169725,144452,25273,Urban,Rural
39059,"Guernsey, Ohio",74.5,38918,14945,23973,Rural,Rural
39061,"Hamilton, Ohio",2017.0,818738,800311,18427,Urban,Urban
39063,"Hancock, Ohio",142.7,75810,52143,23667,Urban,Rural
39065,"Hardin, Ohio",66.8,31407,13796,17611,Rural,Rural
39067,"Harrison, Ohio",37.4,15059,2411,12648,Rural,Rural
39069,"Henry, Ohio",64.9,26991,8458,18533,Rural,Rural
39071,"Highland, Ohio",78.2,43244,11648,31596,Rural,Rural
39073,"Hocking, Ohio",67.2,28312,8198,20114,Rural,Rural
39075,"Holmes, Ohio",103.8,43861,3080,40781,Rural,Rural
39077,"Huron, Ohio",118.7,58344,29015,29329,Urban,Rural
39079,"Jackson, Ohio",77.2,32454,11572,20882,Rural,Rural
39081,"Jefferson, Ohio",160.1,65356,40020,25336,Urban,Rural
39083,"Knox, Ohio",119.1,62577,27812,34765,Urban,Rural
39085,"Lake, Ohio",1014.5,230796,215706,15090,Urban,Urban
39087,"Lawrence, Ohio",131.4,59582,32172,27410,Urban,Rural
39089,"Licking, Ohio",260.3,177657,114360,63297,Urban,Rural
39091,"Logan, Ohio",99.9,45788,19762,26026,Rural,Rural
39093,"Lorain, Ohio",632.7,310712,274228,36484,Urban,Urban
39095,"Lucas, Ohio",1255.5,427945,407908,20037,Urban,Urban
39097,"Madison, Ohio",96.5,44946,22770,22176,Rural,Rural
39099,"Mahoning, Ohio",557.5,229499,194762,34737,Urban,Urban
39101,"Marion, Ohio",161.1,65056,45540,19516,Urban,Rural
39103,"Medina, Ohio",427.9,180310,126500,53810,Urban,Rural
39105,"Meigs, Ohio",53.4,22949,4285,18664,Rural,Rural
39107,"Mercer, Ohio",89.1,41200,15883,25317,Rural,Rural
39109,"Miami, Ohio",264.3,107451,74232,33219,Urban,Rural
39111,"Monroe, Ohio",30.0,13654,320,13334,Rural,Rural
39113,"Montgomery, Ohio",1153.7,532475,509492,22983,Urban,Urban
39115,"Morgan, Ohio",34.9,14529,2677,11852,Rural,Rural
39117,"Morrow, Ohio",87.2,35419,3990,31429,Rural,Rural
39119,"Muskingum, Ohio",130.0,86365,45551,40814,Urban,Rural
39121,"Noble, Ohio",36.3,14439,5462,8977,Rural,Rural
39123,"Ottawa, Ohio",159.4,40643,20512,20131,Rural,Rural
39125,"Paulding, Ohio",44.9,18678,3399,15279,Rural,Rural
39127,"Perry, Ohio",88.7,36189,8962,27227,Rural,Rural
39129,"Pickaway, Ohio",117.1,58684,29514,29170,Urban,Rural
39131,"Pike, Ohio",63.2,27846,7154,20692,Rural,Rural
39133,"Portage, Ohio",333.8,162706,109161,53545,Urban,Rural
39135,"Preble, Ohio",96.5,40907,12602,28305,Rural,Rural
39137,"Putnam, Ohio",70.2,33863,5221,28642,Rural,Rural
39139,"Richland, Ohio",245.5,121566,82615,38951,Urban,Rural
39141,"Ross, Ohio",111.1,76585,31056,45529,Urban,Rural
39143,"Sandusky, Ohio",143.3,58549,32794,25755,Urban,Rural
39145,"Scioto, Ohio",123.6,75397,34293,41104,Urban,Rural
39147,"Seneca, Ohio",100.2,55227,29042,26185,Urban,Rural
39149,"Shelby, Ohio",119.2,48586,23795,24791,Rural,Rural
39151,"Stark, Ohio",645.4,371267,320747,50520,Urban,Urban
39153,"Summit, Ohio",1312.7,541823,520784,21039,Urban,Urban
39155,"Trumbull, Ohio",320.5,198183,144071,54112,Urban,Rural
39157,"Tuscarawas, Ohio",162.2,92063,53711,38352,Urban,Rural
39159,"Union, Ohio",137.4,59309,29480,29829,Urban,Rural
39161,"Van Wert, Ohio",69.2,28311,13909,14402,Rural,Rural
39163,"Vinton, Ohio",31.8,13108,0,13108,Rural,Rural
39165,"Warren, Ohio",587.8,235882,195062,40820,Urban,Urban
39167,"Washington, Ohio",94.9,59961,25802,34159,Urban,Rural
39169,"Wayne, Ohio",208.6,115744,56724,59020,Urban,Rural
39171,"Williams, Ohio",87.3,36762,13307,23455,Rural,Rural
39173,"Wood, Ohio",212.3,131035,92274,38761,Urban,Rural
39175,"Wyandot, Ohio",53.5,21773,9288,12485,Rural,Rural
40001,"Adair, Oklahoma",38.6,22152,3719,18433,Rural,Rural
40003,"Alfalfa, Oklahoma",6.6,5676,0,5676,Rural,Rural
40005,"Atoka, Oklahoma",14.1,13789,0,13789,Rural,Rural
40007,"Beaver, Oklahoma",2.9,5290,0,5290,Rural,Rural
40009,"Beckham, Oklahoma",24.2,21827,14741,7086,Rural,Rural
40011,"Blaine, Oklahoma",10.2,9424,3162,6262,Rural,Rural
40013,"Bryan, Oklahoma",53.4,48290,18596,29694,Rural,Rural
40015,"Caddo, Oklahoma",22.4,28682,5740,22942,Rural,Rural
40017,"Canadian, Oklahoma",166.9,149690,115908,33782,Urban,Rural
40019,"Carter, Oklahoma",58.6,48144,20978,27166,Rural,Rural
40021,"Cherokee, Oklahoma",65.1,48761,19302,29459,Rural,Rural
40023,"Choctaw, Oklahoma",19.0,14665,4805,9860,Rural,Rural
40025,"Cimarron, Oklahoma",1.2,2128,0,2128,Rural,Rural
40027,"Cleveland, Oklahoma",529.3,285168,236812,48356,Urban,Urban
40029,"Coal, Oklahoma",10.6,5485,0,5485,Rural,Rural
40031,"Comanche, Oklahoma",112.8,120613,94237,26376,Urban,Rural
40033,"Cotton, Oklahoma",8.9,5636,2259,3377,Rural,Rural
40035,"Craig, Oklahoma",18.6,14167,5668,8499,Rural,Rural
40037,"Creek, Oklahoma",75.4,71611,32969,38642,Urban,Rural
40039,"Custer, Oklahoma",29.3,28960,20179,8781,Rural,Rural
40041,"Delaware, Oklahoma",58.5,43194,8162,35032,Rural,Rural
40043,"Dewey, Oklahoma",4.9,4882,0,4882,Rural,Rural
40045,"Ellis, Oklahoma",3.1,3850,0,3850,Rural,Rural
40047,"Garfield, Oklahoma",57.5,60833,47771,13062,Urban,Rural
40049,"Garvin, Oklahoma",34.6,27750,8674,19076,Rural,Rural
40051,"Grady, Oklahoma",51.0,56146,20142,36004,Urban,Rural
40053,"Grant, Oklahoma",4.3,4334,0,4334,Rural,Rural
40055,"Greer, Oklahoma",8.9,5714,2651,3063,Rural,Rural
40057,"Harmon, Oklahoma",4.9,2638,0,2638,Rural,Rural
40059,"Harper, Oklahoma",3.6,3693,0,3693,Rural,Rural
40061,"Haskell, Oklahoma",21.9,12650,2831,9819,Rural,Rural
40063,"Hughes, Oklahoma",16.5,13312,5522,7790,Rural,Rural
40065,"Jackson, Oklahoma",30.5,24467,18432,6035,Rural,Rural
40067,"Jefferson, Oklahoma",7.9,5999,0,5999,Rural,Rural
40069,"Johnston, Oklahoma",17.2,11075,0,11075,Rural,Rural
40071,"Kay, Oklahoma",47.3,43528,32917,10611,Rural,Rural
40073,"Kingfisher, Oklahoma",17.6,15796,4320,11476,Rural,Rural
40075,"Kiowa, Oklahoma",8.6,8695,3368,5327,Rural,Rural
40077,"Latimer, Oklahoma",13.9,10065,2697,7368,Rural,Rural
40079,"Le Flore, Oklahoma",31.4,49861,13544,36317,Rural,Rural
40081,"Lincoln, Oklahoma",36.7,34994,2719,32275,Rural,Rural
40083,"Logan, Oklahoma",64.9,48284,21620,26664,Rural,Rural
40085,"Love, Oklahoma",20.0,10291,0,10291,Rural,Rural
40087,"Mcclain, Oklahoma",71.5,40777,9158,31619,Rural,Rural
40089,"Mccurtain, Oklahoma",17.7,32706,10143,22563,Rural,Rural
40091,"Mcintosh, Oklahoma",31.8,19679,2488,17191,Rural,Rural
40093,"Major, Oklahoma",8.0,7629,0,7629,Rural,Rural
40095,"Marshall, Oklahoma",45.9,17047,4747,12300,Rural,Rural
40097,"Mayes, Oklahoma",62.8,41139,9464,31675,Rural,Rural
40099,"Murray, Oklahoma",33.9,14116,7646,6470,Rural,Rural
40101,"Muskogee, Oklahoma",83.9,68022,40029,27993,Urban,Rural
40103,"Noble, Oklahoma",15.2,11126,4845,6281,Rural,Rural
40105,"Nowata, Oklahoma",17.7,10041,4221,5820,Rural,Rural
40107,"Okfuskee, Oklahoma",19.4,12019,3082,8937,Rural,Rural
40109,"Oklahoma, Oklahoma",1127.7,799370,748755,50615,Urban,Urban
40111,"Okmulgee, Oklahoma",55.2,38503,19805,18698,Rural,Rural
40113,"Osage, Oklahoma",20.9,46988,19084,27904,Rural,Rural
40115,"Ottawa, Oklahoma",66.1,31100,15748,15352,Rural,Rural
40117,"Pawnee, Oklahoma",28.9,16396,3107,13289,Rural,Rural
40119,"Payne, Oklahoma",119.3,81665,53898,27767,Urban,Rural
40121,"Pittsburg, Oklahoma",33.4,43654,21055,22599,Rural,Rural
40123,"Pontotoc, Oklahoma",53.1,38275,17773,20502,Rural,Rural
40125,"Pottawatomie, Oklahoma",92.5,72862,35810,37052,Urban,Rural
40127,"Pushmataha, Oklahoma",8.0,11128,0,11128,Rural,Rural
40129,"Roger Mills, Oklahoma",3.1,3580,0,3580,Rural,Rural
40131,"Rogers, Oklahoma",137.4,92825,46087,46738,Urban,Rural
40133,"Seminole, Oklahoma",38.3,24230,8576,15654,Rural,Rural
40135,"Sequoyah, Oklahoma",61.6,41449,13901,27548,Rural,Rural
40137,"Stephens, Oklahoma",49.6,43180,24445,18735,Rural,Rural
40139,"Texas, Oklahoma",9.7,19803,10890,8913,Rural,Rural
40141,"Tillman, Oklahoma",8.3,7232,3497,3735,Rural,Rural
40143,"Tulsa, Oklahoma",1144.5,652649,621219,31430,Urban,Urban
40145,"Wagoner, Oklahoma",145.5,81685,51022,30663,Urban,Rural
40147,"Washington, Oklahoma",124.1,51566,39181,12385,Urban,Rural
40149,"Washita, Oklahoma",10.9,10928,2720,8208,Rural,Rural
40151,"Woods, Oklahoma",6.8,8763,5547,3216,Rural,Rural
40153,"Woodward, Oklahoma",16.2,20102,11307,8795,Rural,Rural
41001,"Baker, Oregon",5.3,16165,9501,6664,Rural,Rural
41003,"Benton, Oregon",137.8,93142,75628,17514,Urban,Rural
41005,"Clackamas, Oregon",224.8,420373,344063,76310,Urban,Rural
41007,"Clatsop, Oregon",48.9,40507,24694,15813,Rural,Rural
41009,"Columbia, Oregon",80.0,52605,29676,22929,Urban,Rural
41011,"Coos, Oregon",40.7,64908,39980,24928,Urban,Rural
41013,"Crook, Oregon",8.3,24708,12772,11936,Rural,Rural
41015,"Curry, Oregon",14.2,23084,14108,8976,Rural,Rural
41017,"Deschutes, Oregon",66.2,199817,144452,55365,Urban,Rural
41019,"Douglas, Oregon",22.2,111731,65832,45899,Urban,Rural
41021,"Gilliam, Oregon",1.6,1927,0,1927,Rural,Rural
41023,"Grant, Oregon",1.6,7215,0,7215,Rural,Rural
41025,"Harney, Oregon",0.7,7438,4138,3300,Rural,Rural
41027,"Hood River, Oregon",44.9,23451,11192,12259,Rural,Rural
41029,"Jackson, Oregon",79.9,222304,177700,44604,Urban,Rural
41031,"Jefferson, Oregon",13.9,24820,9124,15696,Rural,Rural
41033,"Josephine, Oregon",53.7,88059,48296,39763,Urban,Rural
41035,"Klamath, Oregon",11.5,68578,42622,25956,Urban,Rural
41037,"Lake, Oregon",1.0,7906,2903,5003,Rural,Rural
41039,"Lane, Oregon",84.4,384378,316698,67680,Urban,Rural
41041,"Lincoln, Oregon",51.4,50373,31433,18940,Urban,Rural
41043,"Linn, Oregon",57.0,130633,89185,41448,Urban,Rural
41045,"Malheur, Oregon",3.1,30680,15855,14825,Rural,Rural
41047,"Marion, Oregon",295.9,349860,303967,45893,Urban,Rural
41049,"Morrow, Oregon",5.7,11642,6286,5356,Rural,Rural
41051,"Multnomah, Oregon",1886.9,813794,802949,10845,Urban,Urban
41053,"Polk, Oregon",117.1,86735,69284,17451,Urban,Rural
41055,"Sherman, Oregon",2.2,1789,0,1789,Rural,Rural
41057,"Tillamook, Oregon",24.7,27224,8204,19020,Rural,Rural
41059,"Umatilla, Oregon",24.3,78120,55378,22742,Urban,Rural
41061,"Union, Oregon",13.2,26857,15562,11295,Rural,Rural
41063,"Wallowa, Oregon",2.3,7261,0,7261,Rural,Rural
41065,"Wasco, Oregon",11.3,26839,17987,8852,Rural,Rural
41067,"Washington, Oregon",832.3,602808,568726,34082,Urban,Urban
41069,"Wheeler, Oregon",0.8,1341,0,1341,Rural,Rural
41071,"Yamhill, Oregon",150.7,107859,83314,24545,Urban,Rural
42001,"Adams, Pennsylvania",199.0,103207,47892,55315,Urban,Rural
42003,"Allegheny, Pennsylvania",1667.2,1217156,1186824,30332,Urban,Urban
42005,"Armstrong, Pennsylvania",99.0,64671,20938,43733,Urban,Rural
42007,"Beaver, Pennsylvania",377.6,164155,121764,42391,Urban,Rural
42009,"Bedford, Pennsylvania",47.3,47927,7799,40128,Rural,Rural
42011,"Berks, Pennsylvania",492.3,421652,321288,100364,Urban,Rural
42013,"Blair, Pennsylvania",232.0,121996,93524,28472,Urban,Rural
42015,"Bradford, Pennsylvania",52.6,60314,16807,43507,Urban,Rural
42017,"Bucks, Pennsylvania",1042.1,629744,574086,55658,Urban,Urban
42019,"Butler, Pennsylvania",239.2,188610,109653,78957,Urban,Rural
42021,"Cambria, Pennsylvania",189.2,130245,88268,41977,Urban,Rural
42023,"Cameron, Pennsylvania",11.2,4429,2324,2105,Rural,Rural
42025,"Carbon, Pennsylvania",169.0,64450,34127,30323,Urban,Rural
42027,"Centre, Pennsylvania",146.4,162483,110598,51885,Urban,Rural
42029,"Chester, Pennsylvania",701.0,526101,456256,69845,Urban,Urban
42031,"Clarion, Pennsylvania",64.0,38447,8922,29525,Rural,Rural
42033,"Clearfield, Pennsylvania",69.3,79290,36792,42498,Urban,Rural
42035,"Clinton, Pennsylvania",43.6,38697,20762,17935,Rural,Rural
42037,"Columbia, Pennsylvania",134.9,65158,38262,26896,Urban,Rural
42039,"Crawford, Pennsylvania",83.6,84595,30733,53862,Urban,Rural
42041,"Cumberland, Pennsylvania",466.6,254512,197878,56634,Urban,Rural
42043,"Dauphin, Pennsylvania",530.7,278648,241511,37137,Urban,Urban
42045,"Delaware, Pennsylvania",3085.2,567194,564613,2581,Urban,Urban
42047,"Elk, Pennsylvania",36.2,29940,13262,16678,Rural,Rural
42049,"Erie, Pennsylvania",337.3,269522,215483,54039,Urban,Rural
42051,"Fayette, Pennsylvania",163.7,129389,67349,62040,Urban,Rural
42053,"Forest, Pennsylvania",17.0,7267,0,7267,Rural,Rural
42055,"Franklin, Pennsylvania",201.3,155441,92818,62623,Urban,Rural
42057,"Fulton, Pennsylvania",33.3,14581,0,14581,Rural,Rural
42059,"Greene, Pennsylvania",62.7,36139,12125,24014,Rural,Rural
42061,"Huntingdon, Pennsylvania",51.6,45164,14502,30662,Rural,Rural
42063,"Indiana, Pennsylvania",101.7,84134,33745,50389,Urban,Rural
42065,"Jefferson, Pennsylvania",66.6,43459,16735,26724,Rural,Rural
42067,"Juniata, Pennsylvania",63.4,24821,4456,20365,Rural,Rural
42069,"Lackawanna, Pennsylvania",457.6,210085,175563,34522,Urban,Rural
42071,"Lancaster, Pennsylvania",579.0,546497,430449,116048,Urban,Urban
42073,"Lawrence, Pennsylvania",239.0,85588,51168,34420,Urban,Rural
42075,"Lebanon, Pennsylvania",393.3,142311,104343,37968,Urban,Rural
42077,"Lehigh, Pennsylvania",1071.6,369869,340491,29378,Urban,Urban
42079,"Luzerne, Pennsylvania",356.9,317760,254095,63665,Urban,Rural
42081,"Lycoming, Pennsylvania",92.3,113354,72034,41320,Urban,Rural
42083,"Mckean, Pennsylvania",41.5,40628,14810,25818,Rural,Rural
42085,"Mercer, Pennsylvania",162.8,109474,60540,48934,Urban,Rural
42087,"Mifflin, Pennsylvania",112.3,46166,22900,23266,Rural,Rural
42089,"Monroe, Pennsylvania",281.1,170974,105314,65660,Urban,Rural
42091,"Montgomery, Pennsylvania",1725.4,833434,808883,24551,Urban,Urban
42093,"Montour, Pennsylvania",140.0,18230,8547,9683,Rural,Rural
42095,"Northampton, Pennsylvania",828.9,306422,267319,39103,Urban,Urban
42097,"Northumberland, Pennsylvania",198.4,90920,59254,31666,Urban,Rural
42099,"Perry, Pennsylvania",84.1,46379,5382,40997,Rural,Rural
42101,"Philadelphia, Pennsylvania",11806.1,1583217,1583217,0,Urban,Urban
42103,"Pike, Pennsylvania",102.9,56097,16413,39684,Urban,Rural
42105,"Potter, Pennsylvania",15.3,16510,0,16510,Rural,Rural
42107,"Schuylkill, Pennsylvania",181.9,141622,89944,51678,Urban,Rural
42109,"Snyder, Pennsylvania",123.0,40432,13570,26862,Rural,Rural
42111,"Somerset, Pennsylvania",68.5,73548,21874,51674,Urban,Rural
42113,"Sullivan, Pennsylvania",13.5,6073,0,6073,Rural,Rural
42115,"Susquehanna, Pennsylvania",48.9,40307,6454,33853,Rural,Rural
42117,"Tioga, Pennsylvania",35.9,40686,3580,37106,Rural,Rural
42119,"Union, Pennsylvania",142.1,44894,25551,19343,Rural,Rural
42121,"Venango, Pennsylvania",75.1,50654,22893,27761,Urban,Rural
42123,"Warren, Pennsylvania",44.3,39181,17589,21592,Rural,Rural
42125,"Washington, Pennsylvania",242.1,207454,143299,64155,Urban,Rural
42127,"Wayne, Pennsylvania",70.9,51472,6020,45452,Urban,Rural
42129,"Westmoreland, Pennsylvania",340.3,349632,260722,88910,Urban,Rural
42131,"Wyoming, Pennsylvania",67.3,26753,4445,22308,Rural,Rural
42133,"York, Pennsylvania",498.0,450277,338822,111455,Urban,Rural
44001,"Bristol, Rhode Island",2008.6,48535,47975,560,Rural,Urban
44003,"Kent, Rhode Island",976.6,164578,151511,13067,Urban,Urban
44005,"Newport, Rhode Island",801.5,82060,72130,9930,Urban,Urban
44007,"Providence, Rhode Island",1560.7,639097,604020,35077,Urban,Urban
44009,"Washington, Rhode Island",382.1,125801,86897,38904,Urban,Rural
45001,"Abbeville, South Carolina",50.1,24585,5237,19348,Rural,Rural
45003,"Aiken, South Carolina",160.1,171518,107899,63619,Urban,Rural
45005,"Allendale, South Carolina",21.1,8610,2751,5859,Rural,Rural
45007,"Anderson, South Carolina",284.9,203822,126210,77612,Urban,Rural
45009,"Bamberg, South Carolina",35.7,14055,6346,7709,Rural,Rural
45011,"Barnwell, South Carolina",38.0,20833,3637,17196,Rural,Rural
45013,"Beaufort, South Carolina",335.6,193403,155178,38225,Urban,Rural
45015,"Berkeley, South Carolina",209.8,230499,163740,66759,Urban,Rural
45017,"Calhoun, South Carolina",38.2,14560,0,14560,Rural,Rural
45019,"Charleston, South Carolina",451.1,413253,367884,45369,Urban,Rural
45021,"Cherokee, South Carolina",146.4,57479,22512,34967,Urban,Rural
45023,"Chester, South Carolina",55.6,32294,9110,23184,Rural,Rural
45025,"Chesterfield, South Carolina",57.1,45666,12024,33642,Rural,Rural
45027,"Clarendon, South Carolina",55.7,33784,4843,28941,Rural,Rural
45029,"Colleton, South Carolina",35.8,37805,9198,28607,Rural,Rural
45031,"Darlington, South Carolina",118.9,66725,28187,38538,Urban,Rural
45033,"Dillon, South Carolina",75.4,30510,9283,21227,Rural,Rural
45035,"Dorchester, South Carolina",284.8,163262,131862,31400,Urban,Rural
45037,"Edgefield, South Carolina",54.7,27356,7137,20219,Rural,Rural
45039,"Fairfield, South Carolina",32.6,22368,4817,17551,Rural,Rural
45041,"Florence, South Carolina",172.9,138348,85134,53214,Urban,Rural
45043,"Georgetown, South Carolina",77.3,62903,36890,26013,Urban,Rural
45045,"Greenville, South Carolina",670.4,526317,459926,66391,Urban,Urban
45047,"Greenwood, South Carolina",156.0,70953,42651,28302,Urban,Rural
45049,"Hampton, South Carolina",34.3,19216,4133,15083,Rural,Rural
45051,"Horry, South Carolina",316.1,358413,249358,109055,Urban,Rural
45053,"Jasper, South Carolina",46.2,30255,9876,20379,Rural,Rural
45055,"Kershaw, South Carolina",92.0,66839,28197,38642,Urban,Rural
45057,"Lancaster, South Carolina",180.5,99144,50001,49143,Urban,Rural
45059,"Laurens, South Carolina",94.9,67753,24101,43652,Urban,Rural
45061,"Lee, South Carolina",40.7,16711,4504,12207,Rural,Rural
45063,"Lexington, South Carolina",430.2,300653,224516,76137,Urban,Rural
45065,"Mccormick, South Carolina",26.4,9488,0,9488,Rural,Rural
45067,"Marion, South Carolina",62.6,30622,11979,18643,Rural,Rural
45069,"Marlboro, South Carolina",54.3,26059,11578,14481,Rural,Rural
45071,"Newberry, South Carolina",61.2,38569,12435,26134,Rural,Rural
45073,"Oconee, South Carolina",127.8,80021,27993,52028,Urban,Rural
45075,"Orangeburg, South Carolina",77.8,86045,31058,54987,Urban,Rural
45077,"Pickens, South Carolina",257.0,127596,82090,45506,Urban,Rural
45079,"Richland, South Carolina",550.3,416579,378128,38451,Urban,Urban
45081,"Saluda, South Carolina",45.4,20567,4023,16544,Rural,Rural
45083,"Spartanburg, South Carolina",398.8,322177,233573,88604,Urban,Rural
45085,"Sumter, South Carolina",160.6,106840,72703,34137,Urban,Rural
45087,"Union, South Carolina",53.3,27393,9538,17855,Rural,Rural
45089,"Williamsburg, South Carolina",32.4,30265,5469,24796,Rural,Rural
45091,"York, South Carolina",417.2,283935,218627,65308,Urban,Rural
46003,"Aurora, South Dakota",3.9,2749,0,2749,Rural,Rural
46005,"Beadle, South Dakota",14.7,18514,13438,5076,Rural,Rural
46007,"Bennett, South Dakota",2.8,3355,0,3355,Rural,Rural
46009,"Bon Homme, South Dakota",12.3,6931,0,6931,Rural,Rural
46011,"Brookings, South Dakota",44.3,35117,24577,10540,Rural,Rural
46013,"Brown, South Dakota",22.7,38874,27624,11250,Rural,Rural
46015,"Brule, South Dakota",6.5,5304,0,5304,Rural,Rural
46017,"Buffalo, South Dakota",4.1,1955,0,1955,Rural,Rural
46019,"Butte, South Dakota",4.7,10470,5388,5082,Rural,Rural
46021,"Campbell, South Dakota",1.9,1379,0,1379,Rural,Rural
46023,"Charles Mix, South Dakota",8.5,9280,0,9280,Rural,Rural
46025,"Clark, South Dakota",3.9,3742,0,3742,Rural,Rural
46027,"Clay, South Dakota",34.2,14113,10697,3416,Rural,Rural
46029,"Codington, South Dakota",40.7,27993,21733,6260,Rural,Rural
46031,"Corson, South Dakota",1.6,4069,0,4069,Rural,Rural
46033,"Custer, South Dakota",5.8,9000,0,9000,Rural,Rural
46035,"Davison, South Dakota",45.4,19760,15159,4601,Rural,Rural
46037,"Day, South Dakota",5.3,5437,0,5437,Rural,Rural
46039,"Deuel, South Dakota",7.0,4353,0,4353,Rural,Rural
46041,"Dewey, South Dakota",2.6,5882,2125,3757,Rural,Rural
46043,"Douglas, South Dakota",6.8,2926,0,2926,Rural,Rural
46045,"Edmunds, South Dakota",3.4,3825,0,3825,Rural,Rural
46047,"Fall River, South Dakota",3.9,6750,3357,3393,Rural,Rural
46049,"Faulk, South Dakota",2.3,2301,0,2301,Rural,Rural
46051,"Grant, South Dakota",10.3,7047,3157,3890,Rural,Rural
46053,"Gregory, South Dakota",4.1,4198,0,4198,Rural,Rural
46055,"Haakon, South Dakota",1.1,1903,0,1903,Rural,Rural
46057,"Hamlin, South Dakota",12.2,6185,0,6185,Rural,Rural
46059,"Hand, South Dakota",2.2,3193,0,3193,Rural,Rural
46061,"Hanson, South Dakota",8.0,3459,0,3459,Rural,Rural
46063,"Harding, South Dakota",0.5,1301,0,1301,Rural,Rural
46065,"Hughes, South Dakota",23.6,17530,13067,4463,Rural,Rural
46067,"Hutchinson, South Dakota",9.0,7318,0,7318,Rural,Rural
46069,"Hyde, South Dakota",1.5,1304,0,1304,Rural,Rural
46071,"Jackson, South Dakota",1.8,3348,0,3348,Rural,Rural
46073,"Jerauld, South Dakota",3.8,2022,0,2022,Rural,Rural
46075,"Jones, South Dakota",0.9,903,0,903,Rural,Rural
46077,"Kingsbury, South Dakota",5.9,4939,0,4939,Rural,Rural
46079,"Lake, South Dakota",22.8,12843,7017,5826,Rural,Rural
46081,"Lawrence, South Dakota",32.4,25895,16340,9555,Rural,Rural
46083,"Lincoln, South Dakota",107.0,61748,43759,17989,Urban,Rural
46085,"Lyman, South Dakota",2.3,3752,0,3752,Rural,Rural
46087,"Mccook, South Dakota",9.7,5578,0,5578,Rural,Rural
46089,"Mcpherson, South Dakota",2.1,2387,0,2387,Rural,Rural
46091,"Marshall, South Dakota",5.9,4974,0,4974,Rural,Rural
46093,"Meade, South Dakota",8.2,28509,17568,10941,Rural,Rural
46095,"Mellette, South Dakota",1.6,2064,0,2064,Rural,Rural
46097,"Miner, South Dakota",3.9,2225,0,2225,Rural,Rural
46099,"Minnehaha, South Dakota",240.6,194180,167581,26599,Urban,Rural
46101,"Moody, South Dakota",12.7,6617,0,6617,Rural,Rural
46102,"Oglala Lakota, South Dakota",6.7,14118,2798,11320,Rural,Rural
46103,"Pennington, South Dakota",41.2,114285,90410,23875,Urban,Rural
46105,"Perkins, South Dakota",1.0,2858,0,2858,Rural,Rural
46107,"Potter, South Dakota",2.5,2153,0,2153,Rural,Rural
46109,"Roberts, South Dakota",9.5,10415,0,10415,Rural,Rural
46111,"Sanborn, South Dakota",4.1,2345,0,2345,Rural,Rural
46115,"Spink, South Dakota",4.2,6358,0,6358,Rural,Rural
46117,"Stanley, South Dakota",2.2,3110,1788,1322,Rural,Rural
46119,"Sully, South Dakota",1.4,1392,0,1392,Rural,Rural
46121,"Todd, South Dakota",7.3,10138,0,10138,Rural,Rural
46123,"Tripp, South Dakota",3.4,5438,2801,2637,Rural,Rural
46125,"Turner, South Dakota",13.6,8415,0,8415,Rural,Rural
46127,"Union, South Dakota",34.8,16018,6212,9806,Rural,Rural
46129,"Walworth, South Dakota",7.7,5470,3481,1989,Rural,Rural
46135,"Yankton, South Dakota",43.9,22885,14926,7959,Rural,Rural
46137,"Ziebach, South Dakota",1.4,2755,732,2023,Rural,Rural
47001,"Anderson, Tennessee",229.6,77414,50567,26847,Urban,Rural
47003,"Bedford, Tennessee",105.5,49949,22195,27754,Rural,Rural
47005,"Benton, Tennessee",41.2,16232,3560,12672,Rural,Rural
47007,"Bledsoe, Tennessee",37.1,15092,0,15092,Rural,Rural
47009,"Blount, Tennessee",239.6,133854,90043,43811,Urban,Rural
47011,"Bradley, Tennessee",330.0,108478,72575,35903,Urban,Rural
47013,"Campbell, Tennessee",83.0,39864,17962,21902,Rural,Rural
47015,"Cannon, Tennessee",55.7,14792,2792,12000,Rural,Rural
47017,"Carroll, Tennessee",46.4,27830,4804,23026,Rural,Rural
47019,"Carter, Tennessee",165.7,56547,33298,23249,Urban,Rural
47021,"Cheatham, Tennessee",134.8,40761,6933,33828,Rural,Rural
47023,"Chester, Tennessee",60.8,17376,5938,11438,Rural,Rural
47025,"Claiborne, Tennessee",73.8,32064,9145,22919,Rural,Rural
47027,"Clay, Tennessee",32.3,7651,0,7651,Rural,Rural
47029,"Cocke, Tennessee",83.2,36168,11779,24389,Rural,Rural
47031,"Coffee, Tennessee",132.4,56783,30011,26772,Urban,Rural
47033,"Crockett, Tennessee",53.6,14241,4677,9564,Rural,Rural
47035,"Cumberland, Tennessee",89.4,60916,23901,37015,Urban,Rural
47037,"Davidson, Tennessee",1378.1,694617,670765,23852,Urban,Urban
47039,"Decatur, Tennessee",35.0,11698,0,11698,Rural,Rural
47041,"Dekalb, Tennessee",67.7,20614,4509,16105,Rural,Rural
47043,"Dickson, Tennessee",110.8,54267,17520,36747,Urban,Rural
47045,"Dyer, Tennessee",72.6,37192,21255,15937,Rural,Rural
47047,"Fayette, Tennessee",58.6,41325,8777,32548,Rural,Rural
47049,"Fentress, Tennessee",37.3,18613,0,18613,Rural,Rural
47051,"Franklin, Tennessee",76.4,42385,12820,29565,Rural,Rural
47053,"Gibson, Tennessee",81.6,49209,25779,23430,Rural,Rural
47055,"Giles, Tennessee",48.4,29581,7715,21866,Rural,Rural
47057,"Grainger, Tennessee",83.4,23406,0,23406,Rural,Rural
47059,"Greene, Tennessee",111.3,69253,24080,45173,Urban,Rural
47061,"Grundy, Tennessee",37.4,13481,0,13481,Rural,Rural
47063,"Hamblen, Tennessee",403.9,65103,50933,14170,Urban,Rural
47065,"Hamilton, Tennessee",680.5,369150,331676,37474,Urban,Urban
47067,"Hancock, Tennessee",29.8,6636,0,6636,Rural,Rural
47069,"Hardeman, Tennessee",37.5,25022,4951,20071,Rural,Rural
47071,"Hardin, Tennessee",44.6,25752,8243,17509,Rural,Rural
47073,"Hawkins, Tennessee",116.8,56894,24044,32850,Urban,Rural
47075,"Haywood, Tennessee",32.4,17288,9067,8221,Rural,Rural
47077,"Henderson, Tennessee",54.1,28158,6681,21477,Rural,Rural
47079,"Henry, Tennessee",57.7,32457,10722,21735,Rural,Rural
47081,"Hickman, Tennessee",41.3,25297,0,25297,Rural,Rural
47083,"Houston, Tennessee",41.2,8246,0,8246,Rural,Rural
47085,"Humphreys, Tennessee",35.1,18623,3263,15360,Rural,Rural
47087,"Jackson, Tennessee",38.4,11826,0,11826,Rural,Rural
47089,"Jefferson, Tennessee",199.8,54772,22046,32726,Urban,Rural
47091,"Johnson, Tennessee",59.8,17837,2656,15181,Rural,Rural
47093,"Knox, Tennessee",928.7,471965,420273,51692,Urban,Urban
47095,"Lake, Tennessee",43.1,7147,0,7147,Rural,Rural
47097,"Lauderdale, Tennessee",54.0,25499,10624,14875,Rural,Rural
47099,"Lawrence, Tennessee",71.9,44353,10742,33611,Rural,Rural
47101,"Lewis, Tennessee",43.7,12332,3671,8661,Rural,Rural
47103,"Lincoln, Tennessee",60.4,34465,9467,24998,Rural,Rural
47105,"Loudon, Tennessee",237.4,54412,32237,22175,Urban,Rural
47107,"Mcminn, Tennessee",125.5,53988,21444,32544,Urban,Rural
47109,"Mcnairy, Tennessee",45.7,25740,3812,21928,Rural,Rural
47111,"Macon, Tennessee",80.7,24780,5047,19733,Rural,Rural
47113,"Madison, Tennessee",176.2,98153,72890,25263,Urban,Rural
47115,"Marion, Tennessee",58.3,29043,6627,22416,Rural,Rural
47117,"Marshall, Tennessee",92.2,34599,11742,22857,Rural,Rural
47119,"Maury, Tennessee",158.5,97197,56759,40438,Urban,Rural
47121,"Meigs, Tennessee",64.1,12517,0,12517,Rural,Rural
47123,"Monroe, Tennessee",73.6,46760,11178,35582,Rural,Rural
47125,"Montgomery, Tennessee",390.4,210495,168944,41551,Urban,Rural
47127,"Moore, Tennessee",50.3,6497,8,6489,Rural,Rural
47129,"Morgan, Tennessee",41.1,21456,24,21432,Rural,Rural
47131,"Obion, Tennessee",55.2,30090,11540,18550,Rural,Rural
47133,"Overton, Tennessee",51.6,22347,3496,18851,Rural,Rural
47135,"Perry, Tennessee",19.6,8120,0,8120,Rural,Rural
47137,"Pickett, Tennessee",31.1,5075,0,5075,Rural,Rural
47139,"Polk, Tennessee",38.8,16885,0,16885,Rural,Rural
47141,"Putnam, Tennessee",201.4,80766,52394,28372,Urban,Rural
47143,"Rhea, Tennessee",105.8,33353,10625,22728,Rural,Rural
47145,"Roane, Tennessee",148.6,53591,26342,27249,Urban,Rural
47147,"Robertson, Tennessee",151.3,72075,33734,38341,Urban,Rural
47149,"Rutherford, Tennessee",540.9,335013,277576,57437,Urban,Urban
47151,"Scott, Tennessee",41.6,22142,4316,17826,Rural,Rural
47153,"Sequatchie, Tennessee",56.8,15090,3953,11137,Rural,Rural
47155,"Sevier, Tennessee",166.5,98658,42814,55844,Urban,Rural
47157,"Shelby, Tennessee",1226.8,936255,910350,25905,Urban,Urban
47159,"Smith, Tennessee",64.4,20248,3541,16707,Rural,Rural
47161,"Stewart, Tennessee",30.0,13769,0,13769,Rural,Rural
47163,"Sullivan, Tennessee",385.0,159132,118274,40858,Urban,Rural
47165,"Sumner, Tennessee",363.9,192664,138896,53768,Urban,Rural
47167,"Tipton, Tennessee",134.8,61769,27735,34034,Urban,Rural
47169,"Trousdale, Tennessee",98.5,11243,0,11243,Rural,Rural
47171,"Unicoi, Tennessee",96.4,17944,9913,8031,Rural,Rural
47173,"Union, Tennessee",89.9,20089,0,20089,Rural,Rural
47175,"Van Buren, Tennessee",21.6,5900,0,5900,Rural,Rural
47177,"Warren, Tennessee",95.8,41430,16040,25390,Rural,Rural
47179,"Washington, Tennessee",397.6,129815,95284,34531,Urban,Rural
47181,"Wayne, Tennessee",22.8,16711,0,16711,Rural,Rural
47183,"Weakley, Tennessee",57.4,33341,10668,22673,Rural,Rural
47185,"White, Tennessee",73.1,27519,6026,21493,Rural,Rural
47187,"Williamson, Tennessee",412.7,240431,193629,46802,Urban,Rural
47189,"Wilson, Tennessee",255.6,145878,89671,56207,Urban,Rural
48001,"Anderson, Texas",54.4,57813,18857,38956,Urban,Rural
48003,"Andrews, Texas",12.6,18868,15757,3111,Rural,Rural
48005,"Angelina, Texas",108.8,86763,49306,37457,Urban,Rural
48007,"Aransas, Texas",93.3,23511,17052,6459,Rural,Rural
48009,"Archer, Texas",9.5,8584,947,7637,Rural,Rural
48011,"Armstrong, Texas",2.1,1897,0,1897,Rural,Rural
48013,"Atascosa, Texas",42.2,51470,20147,31323,Urban,Rural
48015,"Austin, Texas",46.6,30128,10162,19966,Rural,Rural
48017,"Bailey, Texas",8.4,6967,4956,2011,Rural,Rural
48019,"Bandera, Texas",29.5,23322,0,23322,Rural,Rural
48021,"Bastrop, Texas",100.8,89551,32100,57451,Urban,Rural
48023,"Baylor, Texas",4.1,3517,0,3517,Rural,Rural
48025,"Bee, Texas",37.0,32602,18526,14076,Rural,Rural
48027,"Bell, Texas",347.0,364726,309067,55659,Urban,Rural
48029,"Bexar, Texas",1623.1,2012291,1919718,92573,Urban,Urban
48031,"Blanco, Texas",17.0,12068,0,12068,Rural,Rural
48033,"Borden, Texas",0.7,652,0,652,Rural,Rural
48035,"Bosque, Texas",19.2,18834,3487,15347,Rural,Rural
48037,"Bowie, Texas",105.7,93553,60383,33170,Urban,Rural
48039,"Brazoria, Texas",277.6,376908,293319,83589,Urban,Rural
48041,"Brazos, Texas",393.0,230102,201979,28123,Urban,Rural
48043,"Brewster, Texas",1.5,9198,5983,3215,Rural,Rural
48045,"Briscoe, Texas",1.7,1554,0,1554,Rural,Rural
48047,"Brooks, Texas",7.5,7088,4843,2245,Rural,Rural
48049,"Brown, Texas",40.2,38006,22687,15319,Rural,Rural
48051,"Burleson, Texas",28.1,18543,4306,14237,Rural,Rural
48053,"Burnet, Texas",48.9,48600,21396,27204,Rural,Rural
48055,"Caldwell, Texas",80.6,43937,25228,18709,Rural,Rural
48057,"Calhoun, Texas",41.9,21234,11698,9536,Rural,Rural
48059,"Callahan, Texas",15.6,13986,3923,10063,Rural,Rural
48061,"Cameron, Texas",475.4,423584,387591,35993,Urban,Rural
48063,"Camp, Texas",67.1,13143,5032,8111,Rural,Rural
48065,"Carson, Texas",6.4,5931,277,5654,Rural,Rural
48067,"Cass, Texas",32.2,30125,7857,22268,Rural,Rural
48069,"Castro, Texas",8.4,7517,4063,3454,Rural,Rural
48071,"Chambers, Texas",74.2,44310,24075,20235,Rural,Rural
48073,"Cherokee, Texas",50.2,52835,19303,33532,Urban,Rural
48075,"Childress, Texas",10.5,7283,4685,2598,Rural,Rural
48077,"Clay, Texas",9.6,10498,2662,7836,Rural,Rural
48079,"Cochran, Texas",3.7,2837,0,2837,Rural,Rural
48081,"Coke, Texas",3.7,3412,0,3412,Rural,Rural
48083,"Coleman, Texas",6.5,8179,3910,4269,Rural,Rural
48085,"Collin, Texas",1240.7,1043748,988281,55467,Urban,Urban
48087,"Collingsworth, Texas",3.2,2922,0,2922,Rural,Rural
48089,"Colorado, Texas",22.4,21499,8038,13461,Rural,Rural
48091,"Comal, Texas",284.0,158871,85077,73794,Urban,Rural
48093,"Comanche, Texas",14.6,13682,3898,9784,Rural,Rural
48095,"Concho, Texas",3.1,3004,0,3004,Rural,Rural
48097,"Cooke, Texas",47.4,41487,16939,24548,Rural,Rural
48099,"Coryell, Texas",72.3,76090,61536,14554,Urban,Rural
48101,"Cottle, Texas",1.6,1403,0,1403,Rural,Rural
48103,"Crane, Texas",6.1,4809,4281,528,Rural,Rural
48105,"Crockett, Texas",1.2,3468,2680,788,Rural,Rural
48107,"Crosby, Texas",6.4,5746,0,5746,Rural,Rural
48109,"Culberson, Texas",0.6,2162,0,2162,Rural,Rural
48111,"Dallam, Texas",4.8,7197,5493,1704,Rural,Rural
48113,"Dallas, Texas",3024.1,2634796,2616643,18153,Urban,Urban
48115,"Dawson, Texas",14.1,12720,10618,2102,Rural,Rural
48117,"Deaf Smith, Texas",12.4,18503,15218,3285,Rural,Rural
48119,"Delta, Texas",20.9,5361,0,5361,Rural,Rural
48121,"Denton, Texas",1020.1,896053,833375,62678,Urban,Urban
48123,"Dewitt, Texas",22.2,20212,10170,10042,Rural,Rural
48125,"Dickens, Texas",2.5,2228,0,2228,Rural,Rural
48127,"Dimmit, Texas",7.6,10128,6125,4003,Rural,Rural
48129,"Donley, Texas",3.5,3272,0,3272,Rural,Rural
48131,"Duval, Texas",6.2,11169,3697,7472,Rural,Rural
48133,"Eastland, Texas",19.9,18418,7283,11135,Rural,Rural
48135,"Ector, Texas",186.2,167194,151140,16054,Urban,Rural
48137,"Edwards, Texas",0.9,1946,0,1946,Rural,Rural
48139,"Ellis, Texas",199.7,186805,127152,59653,Urban,Rural
48141,"El Paso, Texas",829.9,840417,822010,18407,Urban,Urban
48143,"Erath, Texas",39.7,43006,23652,19354,Rural,Rural
48145,"Falls, Texas",22.7,17351,5680,11671,Rural,Rural
48147,"Fannin, Texas",40.2,35799,10257,25542,Rural,Rural
48149,"Fayette, Texas",26.8,25471,8240,17231,Rural,Rural
48151,"Fisher, Texas",4.3,3831,0,3831,Rural,Rural
48153,"Floyd, Texas",5.8,5712,2672,3040,Rural,Rural
48155,"Foard, Texas",1.6,1157,0,1157,Rural,Rural
48157,"Fort Bend, Texas",948.5,817103,771873,45230,Urban,Urban
48159,"Franklin, Texas",37.7,10734,3269,7465,Rural,Rural
48161,"Freestone, Texas",22.5,19763,6579,13184,Rural,Rural
48163,"Frio, Texas",17.8,20144,15579,4565,Rural,Rural
48165,"Gaines, Texas",14.3,21555,7953,13602,Rural,Rural
48167,"Galveston, Texas",908.6,343773,322595,21178,Urban,Urban
48169,"Garza, Texas",7.1,6304,4852,1452,Rural,Rural
48171,"Gillespie, Texas",25.7,27214,12658,14556,Rural,Rural
48173,"Glasscock, Texas",1.6,1407,0,1407,Rural,Rural
48175,"Goliad, Texas",9.0,7685,0,7685,Rural,Rural
48177,"Gonzales, Texas",19.6,20902,7266,13636,Rural,Rural
48179,"Gray, Texas",23.5,21802,17281,4521,Rural,Rural
48181,"Grayson, Texas",147.1,137247,77697,59550,Urban,Rural
48183,"Gregg, Texas",455.0,124356,107563,16793,Urban,Rural
48185,"Grimes, Texas",36.9,29086,8881,20205,Rural,Rural
48187,"Guadalupe, Texas",236.7,168350,124238,44112,Urban,Rural
48189,"Hale, Texas",33.3,33419,25688,7731,Rural,Rural
48191,"Hall, Texas",3.4,2963,0,2963,Rural,Rural
48193,"Hamilton, Texas",10.2,8508,3038,5470,Rural,Rural
48195,"Hansford, Texas",5.8,5365,3219,2146,Rural,Rural
48197,"Hardeman, Texas",5.7,3931,0,3931,Rural,Rural
48199,"Hardin, Texas",64.9,57817,28067,29750,Urban,Rural
48201,"Harris, Texas",2766.8,4713171,4655223,57948,Urban,Urban
48203,"Harrison, Texas",74.1,66694,29079,37615,Urban,Rural
48205,"Hartley, Texas",3.8,5552,2453,3099,Rural,Rural
48207,"Haskell, Texas",6.3,5685,3003,2682,Rural,Rural
48209,"Hays, Texas",343.5,232894,157887,75007,Urban,Rural
48211,"Hemphill, Texas",4.2,3790,2751,1039,Rural,Rural
48213,"Henderson, Texas",95.3,83294,33199,50095,Urban,Rural
48215,"Hidalgo, Texas",554.5,871085,826090,44995,Urban,Urban
48217,"Hill, Texas",38.5,36944,8747,28197,Rural,Rural
48219,"Hockley, Texas",25.4,23041,13869,9172,Rural,Rural
48221,"Hood, Texas",148.6,62512,42003,20509,Urban,Rural
48223,"Hopkins, Texas",48.6,37263,14955,22308,Rural,Rural
48225,"Houston, Texas",18.7,23045,6069,16976,Rural,Rural
48227,"Howard, Texas",41.0,36898,29274,7624,Rural,Rural
48229,"Hudspeth, Texas",1.1,4924,0,4924,Rural,Rural
48231,"Hunt, Texas",118.3,99424,43155,56269,Urban,Rural
48233,"Hutchinson, Texas",23.6,20908,16141,4767,Rural,Rural
48235,"Irion, Texas",1.5,1540,0,1540,Rural,Rural
48237,"Jack, Texas",9.8,8969,4181,4788,Rural,Rural
48239,"Jackson, Texas",17.8,14764,5664,9100,Rural,Rural
48241,"Jasper, Texas",38.0,35651,7756,27895,Rural,Rural
48243,"Jeff Davis, Texas",1.0,2286,0,2286,Rural,Rural
48245,"Jefferson, Texas",286.9,251379,230159,21220,Urban,Rural
48247,"Jim Hogg, Texas",4.6,5205,4298,907,Rural,Rural
48249,"Jim Wells, Texas",46.7,40429,24129,16300,Rural,Rural
48251,"Johnson, Texas",244.8,177419,109838,67581,Urban,Rural
48253,"Jones, Texas",21.7,20144,2914,17230,Rural,Rural
48255,"Karnes, Texas",20.8,15560,9482,6078,Rural,Rural
48257,"Kaufman, Texas",177.2,138350,70734,67616,Urban,Rural
48259,"Kendall, Texas",72.6,48115,20225,27890,Rural,Rural
48261,"Kenedy, Texas",0.3,398,0,398,Rural,Rural
48263,"Kent, Texas",0.8,765,0,765,Rural,Rural
48265,"Kerr, Texas",47.9,52872,31113,21759,Urban,Rural
48267,"Kimble, Texas",3.5,4347,2414,1933,Rural,Rural
48269,"King, Texas",0.3,270,0,270,Rural,Rural
48271,"Kinney, Texas",2.7,3682,2926,756,Rural,Rural
48273,"Kleberg, Texas",34.9,30790,24899,5891,Rural,Rural
48275,"Knox, Texas",4.3,3664,0,3664,Rural,Rural
48277,"Lamar, Texas",55.1,49972,26476,23496,Rural,Rural
48279,"Lamb, Texas",12.7,12890,5459,7431,Rural,Rural
48281,"Lampasas, Texas",30.3,21604,6984,14620,Rural,Rural
48283,"La Salle, Texas",5.1,7522,4109,3413,Rural,Rural
48285,"Lavaca, Texas",20.8,20209,3742,16467,Rural,Rural
48287,"Lee, Texas",27.5,17289,5182,12107,Rural,Rural
48289,"Leon, Texas",16.3,17467,0,17467,Rural,Rural
48291,"Liberty, Texas",77.0,89195,32045,57150,Urban,Rural
48293,"Limestone, Texas",26.0,23516,10910,12606,Rural,Rural
48295,"Lipscomb, Texas",3.4,3215,0,3215,Rural,Rural
48297,"Live Oak, Texas",11.8,12226,0,12226,Rural,Rural
48299,"Llano, Texas",23.6,22001,12027,9974,Rural,Rural
48301,"Loving, Texas",0.3,175,0,175,Rural,Rural
48303,"Lubbock, Texas",348.0,311645,275888,35757,Urban,Rural
48305,"Lynn, Texas",6.7,5978,2579,3399,Rural,Rural
48307,"Mcculloch, Texas",7.5,7999,5155,2844,Rural,Rural
48309,"Mclennan, Texas",248.5,257693,196676,61017,Urban,Rural
48311,"Mcmullen, Texas",0.7,743,0,743,Rural,Rural
48313,"Madison, Texas",30.7,14328,4717,9611,Rural,Rural
48315,"Marion, Texas",25.9,9867,0,9867,Rural,Rural
48317,"Martin, Texas",6.4,5835,0,5835,Rural,Rural
48319,"Mason, Texas",4.6,4304,0,4304,Rural,Rural
48321,"Matagorda, Texas",33.3,36607,23237,13370,Rural,Rural
48323,"Maverick, Texas",45.9,58732,53327,5405,Urban,Rural
48325,"Medina, Texas",39.1,51848,19895,31953,Urban,Rural
48327,"Menard, Texas",2.4,2154,0,2154,Rural,Rural
48329,"Midland, Texas",197.8,178043,155672,22371,Urban,Rural
48331,"Milam, Texas",24.5,24933,10887,14046,Rural,Rural
48333,"Mills, Texas",6.5,4898,0,4898,Rural,Rural
48335,"Mitchell, Texas",9.3,8476,5198,3278,Rural,Rural
48337,"Montague, Texas",21.4,19934,8129,11805,Rural,Rural
48339,"Montgomery, Texas",588.7,613316,473256,140060,Urban,Urban
48341,"Moore, Texas",23.3,20973,17464,3509,Rural,Rural
48343,"Morris, Texas",49.4,12438,2676,9762,Rural,Rural
48345,"Motley, Texas",1.2,1203,0,1203,Rural,Rural
48347,"Nacogdoches, Texas",69.0,65356,34748,30608,Urban,Rural
48349,"Navarro, Texas",49.9,50352,23806,26546,Urban,Rural
48351,"Newton, Texas",14.5,13577,0,13577,Rural,Rural
48353,"Nolan, Texas",16.1,14671,9831,4840,Rural,Rural
48355,"Nueces, Texas",432.3,362464,338899,23565,Urban,Rural
48357,"Ochiltree, Texas",10.7,9806,8435,1371,Rural,Rural
48359,"Oldham, Texas",1.4,2120,0,2120,Rural,Rural
48361,"Orange, Texas",250.0,83406,54016,29390,Urban,Rural
48363,"Palo Pinto, Texas",30.8,29306,14465,14841,Rural,Rural
48365,"Panola, Texas",29.0,23217,6363,16854,Rural,Rural
48367,"Parker, Texas",160.1,144637,62154,82483,Urban,Rural
48369,"Parmer, Texas",10.9,9610,3814,5796,Rural,Rural
48371,"Pecos, Texas",3.3,15827,9544,6283,Rural,Rural
48373,"Polk, Texas",49.0,51850,11686,40164,Urban,Rural
48375,"Potter, Texas",129.0,117197,106624,10573,Urban,Rural
48377,"Presidio, Texas",1.7,6653,3949,2704,Rural,Rural
48379,"Rains, Texas",55.2,12665,865,11800,Rural,Rural
48381,"Randall, Texas",152.1,138607,118450,20157,Urban,Rural
48383,"Reagan, Texas",3.3,3838,3319,519,Rural,Rural
48385,"Real, Texas",5.0,3470,0,3470,Rural,Rural
48387,"Red River, Texas",11.6,12053,2910,9143,Rural,Rural
48389,"Reeves, Texas",6.1,16112,13842,2270,Rural,Rural
48391,"Refugio, Texas",9.0,6925,2728,4197,Rural,Rural
48393,"Roberts, Texas",0.9,847,0,847,Rural,Rural
48395,"Robertson, Texas",20.0,17123,4454,12669,Rural,Rural
48397,"Rockwall, Texas",837.5,106387,89172,17215,Urban,Urban
48399,"Runnels, Texas",9.8,10303,6065,4238,Rural,Rural
48401,"Rusk, Texas",58.9,54440,18929,35511,Urban,Rural
48403,"Sabine, Texas",21.6,10602,0,10602,Rural,Rural
48405,"San Augustine, Texas",15.5,8241,0,8241,Rural,Rural
48407,"San Jacinto, Texas",51.0,29047,0,29047,Rural,Rural
48409,"San Patricio, Texas",96.2,66732,53600,13132,Urban,Rural
48411,"San Saba, Texas",5.3,6072,3084,2988,Rural,Rural
48413,"Schleicher, Texas",2.1,2769,0,2769,Rural,Rural
48415,"Scurry, Texas",18.4,16670,11370,5300,Rural,Rural
48417,"Shackelford, Texas",3.6,3264,0,3264,Rural,Rural
48419,"Shelby, Texas",31.9,25351,5209,20142,Rural,Rural
48421,"Sherman, Texas",3.3,3013,0,3013,Rural,Rural
48423,"Smith, Texas",253.9,233917,159815,74102,Urban,Rural
48425,"Somervell, Texas",49.3,9190,0,9190,Rural,Rural
48427,"Starr, Texas",52.9,64703,49427,15276,Urban,Rural
48429,"Stephens, Texas",10.5,9405,5623,3782,Rural,Rural
48431,"Sterling, Texas",1.4,1296,0,1296,Rural,Rural
48433,"Stonewall, Texas",1.5,1352,0,1352,Rural,Rural
48435,"Sutton, Texas",2.6,3759,3053,706,Rural,Rural
48437,"Swisher, Texas",8.3,7418,4613,2805,Rural,Rural
48439,"Tarrant, Texas",2441.7,2108659,2081161,27498,Urban,Urban
48441,"Taylor, Texas",151.1,138325,115927,22398,Urban,Rural
48443,"Terrell, Texas",0.3,776,0,776,Rural,Rural
48445,"Terry, Texas",13.9,12315,9229,3086,Rural,Rural
48447,"Throckmorton, Texas",1.6,1503,0,1503,Rural,Rural
48449,"Titus, Texas",81.0,32872,16313,16559,Rural,Rural
48451,"Tom Green, Texas",78.5,119536,100717,18819,Urban,Rural
48453,"Travis, Texas",1293.8,1281160,1209828,71332,Urban,Urban
48455,"Trinity, Texas",21.2,14709,3388,11321,Rural,Rural
48457,"Tyler, Texas",23.6,21790,4677,17113,Rural,Rural
48459,"Upshur, Texas",72.0,41979,8647,33332,Rural,Rural
48461,"Upton, Texas",3.0,3662,0,3662,Rural,Rural
48463,"Uvalde, Texas",17.2,26722,18320,8402,Rural,Rural
48465,"Val Verde, Texas",15.6,49032,44030,5002,Rural,Rural
48467,"Van Zandt, Texas",67.6,56946,13979,42967,Urban,Rural
48469,"Victoria, Texas",104.5,92153,67462,24691,Urban,Rural
48471,"Walker, Texas",92.9,72886,39522,33364,Urban,Rural
48473,"Waller, Texas",108.4,55642,21296,34346,Urban,Rural
48475,"Ward, Texas",14.4,12063,8689,3374,Rural,Rural
48477,"Washington, Texas",59.6,35975,16980,18995,Rural,Rural
48479,"Webb, Texas",82.3,276781,269490,7291,Urban,Rural
48481,"Wharton, Texas",38.3,41620,20741,20879,Rural,Rural
48483,"Wheeler, Texas",5.5,5036,0,5036,Rural,Rural
48485,"Wichita, Texas",211.1,132532,118210,14322,Urban,Rural
48487,"Wilbarger, Texas",13.2,12800,9979,2821,Rural,Rural
48489,"Willacy, Texas",36.2,21361,13990,7371,Rural,Rural
48491,"Williamson, Texas",533.8,596980,524955,72025,Urban,Urban
48493,"Wilson, Texas",64.0,51470,7175,44295,Urban,Rural
48495,"Winkler, Texas",9.5,8007,6561,1446,Rural,Rural
48497,"Wise, Texas",78.2,70753,19506,51247,Urban,Rural
48499,"Wood, Texas",71.2,45916,11957,33959,Rural,Rural
48501,"Yoakum, Texas",10.9,8689,5423,3266,Rural,Rural
48503,"Young, Texas",19.8,18069,11990,6079,Rural,Rural
48505,"Zapata, Texas",14.2,14136,10806,3330,Rural,Rural
48507,"Zavala, Texas",9.1,11813,7344,4469,Rural,Rural
49001,"Beaver, Utah",2.6,6725,2917,3808,Rural,Rural
49003,"Box Elder, Utah",9.8,56345,38680,17665,Urban,Rural
49005,"Cache, Utah",110.6,128849,108676,20173,Urban,Rural
49007,"Carbon, Utah",13.9,20560,13557,7003,Rural,Rural
49009,"Daggett, Utah",1.5,1030,0,1030,Rural,Rural
49011,"Davis, Utah",1194.2,356803,353518,3285,Urban,Urban
49013,"Duchesne, Utah",6.1,19882,6346,13536,Rural,Rural
49015,"Emery, Utah",2.2,10017,2638,7379,Rural,Rural
49017,"Garfield, Utah",1.0,5087,0,5087,Rural,Rural
49019,"Grand, Utah",2.7,9803,7318,2485,Rural,Rural
49021,"Iron, Utah",16.9,55582,42954,12628,Urban,Rural
49023,"Juab, Utah",3.6,12092,6849,5243,Rural,Rural
49025,"Kane, Utah",2.0,7964,3669,4295,Rural,Rural
49027,"Millard, Utah",2.0,13240,3492,9748,Rural,Rural
49029,"Morgan, Utah",20.0,12208,4541,7667,Rural,Rural
49031,"Piute, Utah",2.0,1490,0,1490,Rural,Rural
49033,"Rich, Utah",2.4,2497,0,2497,Rural,Rural
49035,"Salt Lake, Utah",1568.2,1164021,1153443,10578,Urban,Urban
49037,"San Juan, Utah",2.0,15416,3449,11967,Rural,Rural
49039,"Sanpete, Utah",19.6,31151,18425,12726,Rural,Rural
49041,"Sevier, Utah",11.4,21688,7666,14022,Rural,Rural
49043,"Summit, Utah",22.6,42247,25633,16614,Rural,Rural
49045,"Tooele, Utah",10.5,72942,59968,12974,Urban,Rural
49047,"Uintah, Utah",8.0,35688,18984,16704,Rural,Rural
49049,"Utah, Utah",319.2,639599,618123,21476,Urban,Rural
49051,"Wasatch, Utah",29.4,34547,25384,9163,Rural,Rural
49053,"Washington, Utah",74.0,179541,152445,27096,Urban,Rural
49055,"Wayne, Utah",1.1,2711,0,2711,Rural,Rural
49057,"Weber, Utah",454.0,261558,246213,15345,Urban,Rural
50001,"Addison, Vermont",48.1,36876,8035,28841,Rural,Rural
50003,"Bennington, Vermont",52.7,35555,12665,22890,Rural,Rural
50005,"Caledonia, Vermont",46.2,30002,7656,22346,Rural,Rural
50007,"Chittenden, Vermont",306.3,164350,121437,42913,Urban,Rural
50009,"Essex, Vermont",9.3,6177,0,6177,Rural,Rural
50011,"Franklin, Vermont",78.2,49536,13942,35594,Rural,Rural
50013,"Grand Isle, Vermont",88.9,7276,0,7276,Rural,Rural
50015,"Lamoille, Vermont",55.4,25401,0,25401,Rural,Rural
50017,"Orange, Vermont",42.1,28951,804,28147,Rural,Rural
50019,"Orleans, Vermont",39.1,27133,3956,23177,Rural,Rural
50021,"Rutland, Vermont",62.6,58210,22598,35612,Urban,Rural
50023,"Washington, Vermont",85.4,58698,27871,30827,Urban,Rural
50025,"Windham, Vermont",53.7,42164,13358,28806,Rural,Rural
50027,"Windsor, Vermont",56.9,55114,13461,41653,Urban,Rural
51001,"Accomack, Virginia",71.8,32256,0,32256,Rural,Rural
51003,"Albemarle, Virginia",152.3,109785,60230,49555,Urban,Rural
51005,"Alleghany, Virginia",33.3,14848,7087,7761,Rural,Rural
51007,"Amelia, Virginia",37.1,13195,0,13195,Rural,Rural
51009,"Amherst, Virginia",66.7,31605,11511,20094,Rural,Rural
51011,"Appomattox, Virginia",47.8,15957,0,15957,Rural,Rural
51013,"Arlington, Virginia",9125.0,237016,237016,0,Urban,Urban
51015,"Augusta, Virginia",78.4,75832,25477,50355,Urban,Rural
51017,"Bath, Virginia",7.9,4161,0,4161,Rural,Rural
51019,"Bedford, Virginia",104.3,79279,22101,57178,Urban,Rural
51021,"Bland, Virginia",17.6,6284,0,6284,Rural,Rural
51023,"Botetourt, Virginia",61.9,33520,12011,21509,Rural,Rural
51025,"Brunswick, Virginia",28.6,16206,4071,12135,Rural,Rural
51027,"Buchanan, Virginia",41.6,20908,0,20908,Rural,Rural
51029,"Buckingham, Virginia",29.7,17191,0,17191,Rural,Rural
51031,"Campbell, Virginia",108.9,54854,21359,33495,Urban,Rural
51033,"Caroline, Virginia",58.5,30846,6690,24156,Rural,Rural
51035,"Carroll, Virginia",62.9,29837,848,28989,Rural,Rural
51036,"Charles City, Virginia",38.1,6960,0,6960,Rural,Rural
51037,"Charlotte, Virginia",25.0,11876,0,11876,Rural,Rural
51041,"Chesterfield, Virginia",838.0,354707,333458,21249,Urban,Urban
51043,"Clarke, Virginia",83.4,14685,4416,10269,Rural,Rural
51045,"Craig, Virginia",15.6,5141,0,5141,Rural,Rural
51047,"Culpeper, Virginia",139.3,52816,20222,32594,Urban,Rural
51049,"Cumberland, Virginia",33.4,9950,405,9545,Rural,Rural
51051,"Dickenson, Virginia",43.2,14294,0,14294,Rural,Rural
51053,"Dinwiddie, Virginia",56.7,28539,8220,20319,Rural,Rural
51057,"Essex, Virginia",42.7,10983,2481,8502,Rural,Rural
51059,"Fairfax, Virginia",2929.4,1145312,1129307,16005,Urban,Urban
51061,"Fauquier, Virginia",110.6,71619,30462,41157,Urban,Rural
51063,"Floyd, Virginia",41.5,15799,0,15799,Rural,Rural
51065,"Fluvanna, Virginia",95.8,27395,10175,17220,Rural,Rural
51067,"Franklin, Virginia",81.4,56175,6023,50152,Urban,Rural
51069,"Frederick, Virginia",217.5,89939,49606,40333,Urban,Rural
51071,"Giles, Virginia",47.2,16778,5646,11132,Rural,Rural
51073,"Gloucester, Virginia",171.9,37442,13233,24209,Rural,Rural
51075,"Goochland, Virginia",85.2,23980,748,23232,Rural,Rural
51077,"Grayson, Virginia",35.1,15536,17,15519,Rural,Rural
51079,"Greene, Virginia",127.3,19897,9731,10166,Rural,Rural
51081,"Greensville, Virginia",38.6,11399,1454,9945,Rural,Rural
51083,"Halifax, Virginia",41.4,33891,7846,26045,Rural,Rural
51085,"Hanover, Virginia",231.4,108403,66045,42358,Urban,Rural
51087,"Henrico, Virginia",1418.4,331469,317295,14174,Urban,Urban
51089,"Henry, Virginia",132.3,50586,19843,30743,Urban,Rural
51091,"Highland, Virginia",5.3,2195,0,2195,Rural,Rural
51093,"Isle Of Wight, Virginia",118.1,37270,15938,21332,Rural,Rural
51095,"James City, Virginia",541.0,77062,64744,12318,Urban,Urban
51097,"King And Queen, Virginia",22.4,7053,0,7053,Rural,Rural
51099,"King George, Virginia",149.9,26931,7189,19742,Rural,Rural
51101,"King William, Virginia",62.9,17242,2853,14389,Rural,Rural
51103,"Lancaster, Virginia",80.2,10685,0,10685,Rural,Rural
51105,"Lee, Virginia",53.7,23367,105,23262,Rural,Rural
51107,"Loudoun, Virginia",807.0,416080,363198,52882,Urban,Urban
51109,"Louisa, Virginia",76.4,37902,0,37902,Rural,Rural
51111,"Lunenburg, Virginia",28.2,12163,0,12163,Rural,Rural
51113,"Madison, Virginia",41.5,13318,0,13318,Rural,Rural
51115,"Mathews, Virginia",103.5,8891,0,8891,Rural,Rural
51117,"Mecklenburg, Virginia",49.0,30670,6864,23806,Rural,Rural
51119,"Middlesex, Virginia",81.5,10626,0,10626,Rural,Rural
51121,"Montgomery, Virginia",255.4,98852,74314,24538,Urban,Rural
51125,"Nelson, Virginia",31.8,14980,0,14980,Rural,Rural
51127,"New Kent, Virginia",111.4,23370,0,23370,Rural,Rural
51131,"Northampton, Virginia",55.3,11705,0,11705,Rural,Rural
51133,"Northumberland, Virginia",63.4,12119,0,12119,Rural,Rural
51135,"Nottoway, Virginia",48.5,15250,7429,7821,Rural,Rural
51137,"Orange, Virginia",109.5,37319,15861,21458,Rural,Rural
51139,"Page, Virginia",77.1,23971,4764,19207,Rural,Rural
51141,"Patrick, Virginia",36.5,17650,0,17650,Rural,Rural
51143,"Pittsylvania, Virginia",62.4,60415,8672,51743,Urban,Rural
51145,"Powhatan, Virginia",114.6,29810,103,29707,Rural,Rural
51147,"Prince Edward, Virginia",65.3,22858,8395,14463,Rural,Rural
51149,"Prince George, Virginia",144.8,38389,17165,21224,Rural,Rural
51153,"Prince William, Virginia",1399.9,470928,451140,19788,Urban,Urban
51155,"Pulaski, Virginia",106.6,34083,18124,15959,Rural,Rural
51157,"Rappahannock, Virginia",27.6,7352,0,7352,Rural,Rural
51159,"Richmond, Virginia",47.5,9098,0,9098,Rural,Rural
51161,"Roanoke, Virginia",377.1,94477,76955,17522,Urban,Rural
51163,"Rockbridge, Virginia",37.9,22665,2029,20636,Rural,Rural
51165,"Rockingham, Virginia",96.9,82301,33563,48738,Urban,Rural
51167,"Russell, Virginia",56.0,26556,3168,23388,Rural,Rural
51169,"Scott, Virginia",40.2,21544,3817,17727,Rural,Rural
51171,"Shenandoah, Virginia",86.0,43767,14569,29198,Rural,Rural
51173,"Smyth, Virginia",66.8,30113,7461,22652,Rural,Rural
51175,"Southampton, Virginia",29.4,17600,356,17244,Rural,Rural
51177,"Spotsylvania, Virginia",341.1,136944,92704,44240,Urban,Rural
51179,"Stafford, Virginia",572.0,153837,123324,30513,Urban,Urban
51181,"Surry, Virginia",23.0,6423,0,6423,Rural,Rural
51183,"Sussex, Virginia",22.8,11154,0,11154,Rural,Rural
51185,"Tazewell, Virginia",78.1,40542,19356,21186,Rural,Rural
51187,"Warren, Virginia",189.0,40343,19979,20364,Rural,Rural
51191,"Washington, Virginia",96.2,53985,15306,38679,Urban,Rural
51193,"Westmoreland, Virginia",79.0,18111,3787,14324,Rural,Rural
51195,"Wise, Virginia",92.6,37343,16130,21213,Rural,Rural
51197,"Wythe, Virginia",62.3,28761,7084,21677,Rural,Rural
51199,"York, Virginia",652.1,68329,64145,4184,Urban,Urban
51510,"Alexandria City, Virginia",10600.9,159299,159299,0,Urban,Urban
51520,"Bristol City, Virginia",1285.9,16734,16727,7,Rural,Urban
51530,"Buena Vista City, Virginia",955.9,6408,6161,247,Rural,Urban
51540,"Charlottesville City, Virginia",4631.2,47416,47416,0,Rural,Urban
51550,"Chesapeake City, Virginia",721.5,245878,226963,18915,Urban,Urban
51570,"Colonial Heights City, Virginia",2328.9,17513,17513,0,Rural,Urban
51580,"Covington City, Virginia",1007.0,5507,5507,0,Rural,Urban
51590,"Danville City, Virginia",932.2,40024,38231,1793,Rural,Urban
51595,"Emporia City, Virginia",762.4,5256,4926,330,Rural,Urban
51600,"Fairfax City, Virginia",3883.8,24232,24232,0,Rural,Urban
51610,"Falls Church City, Virginia",7397.5,14786,14786,0,Rural,Urban
51620,"Franklin City, Virginia",966.1,7928,7669,259,Rural,Urban
51630,"Fredericksburg City, Virginia",2784.3,29069,28730,339,Rural,Urban
51640,"Galax City, Virginia",776.0,6394,5517,877,Rural,Urban
51650,"Hampton City, Virginia",2616.1,134502,134169,333,Urban,Urban
51660,"Harrisonburg City, Virginia",3046.8,53070,53070,0,Urban,Urban
51670,"Hopewell City, Virginia",2198.7,22599,22599,0,Rural,Urban
51678,"Lexington City, Virginia",2977.7,7435,7435,0,Rural,Urban
51680,"Lynchburg City, Virginia",1682.6,82661,80413,2248,Urban,Urban
51683,"Manassas City, Virginia",4167.9,41182,41182,0,Rural,Urban
51685,"Manassas Park City, Virginia",6877.5,17426,17426,0,Rural,Urban
51690,"Martinsville City, Virginia",1156.4,12670,12670,0,Rural,Urban
51700,"Newport News City, Virginia",2604.5,178968,178918,50,Urban,Urban
51710,"Norfolk City, Virginia",4478.8,242393,242393,0,Urban,Urban
51720,"Norton City, Virginia",533.8,3993,3890,103,Rural,Urban
51730,"Petersburg City, Virginia",1374.5,31520,30855,665,Rural,Urban
51735,"Poquoson City, Virginia",805.2,12333,11539,794,Rural,Urban
51740,"Portsmouth City, Virginia",2798.0,94161,94161,0,Urban,Urban
51750,"Radford City, Virginia",1875.3,18512,17984,528,Rural,Urban
51760,"Richmond City, Virginia",3855.5,230581,230581,0,Urban,Urban
51770,"Roanoke City, Virginia",2337.8,99499,99493,6,Urban,Urban
51775,"Salem City, Virginia",1765.3,25485,25485,0,Rural,Urban
51790,"Staunton City, Virginia",1259.5,25159,24248,911,Rural,Urban
51800,"Suffolk City, Virginia",231.2,92505,72518,19987,Urban,Rural
51810,"Virginia Beach City, Virginia",1806.4,449825,442896,6929,Urban,Urban
51820,"Waynesboro City, Virginia",1512.5,22747,22164,583,Rural,Urban
51830,"Williamsburg City, Virginia",1655.2,14933,14933,0,Rural,Urban
51840,"Winchester City, Virginia",3040.5,28072,28072,0,Rural,Urban
53001,"Adams, Washington",10.4,19951,11947,8004,Rural,Rural
53003,"Asotin, Washington",35.6,22661,21135,1526,Rural,Rural
53005,"Benton, Washington",120.9,205544,183733,21811,Urban,Rural
53007,"Chelan, Washington",26.6,77560,56231,21329,Urban,Rural
53009,"Clallam, Washington",44.8,77895,50327,27568,Urban,Rural
53011,"Clark, Washington",780.9,491178,423321,67857,Urban,Urban
53013,"Columbia, Washington",4.6,3994,2615,1379,Rural,Rural
53015,"Cowlitz, Washington",97.8,111506,79377,32129,Urban,Rural
53017,"Douglas, Washington",24.0,43661,32057,11604,Rural,Rural
53019,"Ferry, Washington",3.5,7654,0,7654,Rural,Rural
53021,"Franklin, Washington",77.0,95621,82795,12826,Urban,Rural
53023,"Garfield, Washington",3.1,2230,0,2230,Rural,Rural
53025,"Grant, Washington",36.6,97947,60079,37868,Urban,Rural
53027,"Grays Harbor, Washington",39.8,75631,45334,30297,Urban,Rural
53029,"Island, Washington",411.0,85674,45488,40186,Urban,Rural
53031,"Jefferson, Washington",18.0,32497,13893,18604,Rural,Rural
53033,"King, Washington",1065.0,2253103,2180687,72416,Urban,Urban
53035,"Kitsap, Washington",690.8,272826,226997,45829,Urban,Urban
53037,"Kittitas, Washington",21.0,48272,28835,19437,Rural,Rural
53039,"Klickitat, Washington",12.1,22577,9006,13571,Rural,Rural
53041,"Lewis, Washington",33.8,81237,31890,49347,Urban,Rural
53043,"Lincoln, Washington",4.8,11025,0,11025,Rural,Rural
53045,"Mason, Washington",70.2,67320,24371,42949,Urban,Rural
53047,"Okanogan, Washington",8.0,42267,8421,33846,Rural,Rural
53049,"Pacific, Washington",24.3,22618,7961,14657,Rural,Rural
53051,"Pend Oreille, Washington",9.9,13832,2376,11456,Rural,Rural
53053,"Pierce, Washington",544.2,908629,848326,60303,Urban,Urban
53055,"San Juan, Washington",102.1,17750,0,17750,Rural,Rural
53057,"Skagit, Washington",75.1,129990,92276,37714,Urban,Rural
53059,"Skamania, Washington",7.3,12148,0,12148,Rural,Rural
53061,"Snohomish, Washington",395.6,825706,735620,90086,Urban,Rural
53063,"Spokane, Washington",298.4,526261,453973,72288,Urban,Rural
53065,"Stevens, Washington",18.6,46019,9526,36493,Rural,Rural
53067,"Thurston, Washington",405.4,292672,231052,61620,Urban,Rural
53069,"Wahkiakum, Washington",17.2,4537,0,4537,Rural,Rural
53071,"Walla Walla, Washington",48.1,61044,50559,10485,Urban,Rural
53073,"Whatcom, Washington",109.6,230843,171001,59842,Urban,Rural
53075,"Whitman, Washington",23.3,50295,36412,13883,Urban,Rural
53077,"Yakima, Washington",58.5,251228,192066,59162,Urban,Rural
54001,"Barbour, West Virginia",48.3,16467,2926,13541,Rural,Rural
54003,"Berkeley, West Virginia",373.4,119919,81745,38174,Urban,Rural
54005,"Boone, West Virginia",42.6,21373,3988,17385,Rural,Rural
54007,"Braxton, West Virginia",27.3,13960,0,13960,Rural,Rural
54009,"Brooke, West Virginia",246.5,21990,12714,9276,Rural,Rural
54011,"Cabell, West Virginia",326.8,91844,72101,19743,Urban,Rural
54013,"Calhoun, West Virginia",25.5,7115,0,7115,Rural,Rural
54015,"Clay, West Virginia",24.9,8500,0,8500,Rural,Rural
54017,"Doddridge, West Virginia",26.3,8400,0,8400,Rural,Rural
54019,"Fayette, West Virginia",64.0,42371,17913,24458,Rural,Rural
54021,"Gilmer, West Virginia",23.2,7855,2979,4876,Rural,Rural
54023,"Grant, West Virginia",24.3,11594,2444,9150,Rural,Rural
54025,"Greenbrier, West Virginia",34.0,34680,10431,24249,Rural,Rural
54027,"Hampshire, West Virginia",36.3,23220,0,23220,Rural,Rural
54029,"Hancock, West Virginia",349.0,28829,20049,8780,Rural,Rural
54031,"Hardy, West Virginia",23.7,13774,2671,11103,Rural,Rural
54033,"Harrison, West Virginia",161.8,67306,42408,24898,Urban,Rural
54035,"Jackson, West Virginia",61.6,28601,8159,20442,Rural,Rural
54037,"Jefferson, West Virginia",273.4,57323,29529,27794,Urban,Rural
54039,"Kanawha, West Virginia",197.1,177729,133100,44629,Urban,Rural
54041,"Lewis, West Virginia",41.4,15924,4949,10975,Rural,Rural
54043,"Lincoln, West Virginia",46.7,20394,0,20394,Rural,Rural
54045,"Logan, West Virginia",70.3,31917,9407,22510,Rural,Rural
54047,"Mcdowell, West Virginia",32.9,17537,2334,15203,Rural,Rural
54049,"Marion, West Virginia",181.8,56135,32906,23229,Urban,Rural
54051,"Marshall, West Virginia",99.8,30477,15478,14999,Rural,Rural
54053,"Mason, West Virginia",61.6,26539,9264,17275,Rural,Rural
54055,"Mercer, West Virginia",140.2,58727,34767,23960,Urban,Rural
54057,"Mineral, West Virginia",82.0,26892,9533,17359,Rural,Rural
54059,"Mingo, West Virginia",55.1,23322,2385,20937,Rural,Rural
54061,"Monongalia, West Virginia",293.9,105812,76925,28887,Urban,Rural
54063,"Monroe, West Virginia",28.1,13284,1519,11765,Rural,Rural
54065,"Morgan, West Virginia",78.3,17940,0,17940,Rural,Rural
54067,"Nicholas, West Virginia",37.8,24464,3129,21335,Rural,Rural
54069,"Ohio, West Virginia",391.1,41383,31925,9458,Rural,Rural
54071,"Pendleton, West Virginia",10.0,6990,0,6990,Rural,Rural
54073,"Pleasants, West Virginia",57.6,7496,3404,4092,Rural,Rural
54075,"Pocahontas, West Virginia",8.8,8240,0,8240,Rural,Rural
54077,"Preston, West Virginia",51.7,33544,3212,30332,Rural,Rural
54079,"Putnam, West Virginia",163.7,56576,36340,20236,Urban,Rural
54081,"Raleigh, West Virginia",121.1,73307,44622,28685,Urban,Rural
54083,"Randolph, West Virginia",27.6,28727,10758,17969,Rural,Rural
54085,"Ritchie, West Virginia",21.1,9531,0,9531,Rural,Rural
54087,"Roane, West Virginia",28.3,13689,2750,10939,Rural,Rural
54089,"Summers, West Virginia",35.0,12613,3417,9196,Rural,Rural
54091,"Taylor, West Virginia",96.8,16719,6740,9979,Rural,Rural
54093,"Tucker, West Virginia",16.3,6835,0,6835,Rural,Rural
54095,"Tyler, West Virginia",33.5,8583,782,7801,Rural,Rural
54097,"Upshur, West Virginia",68.2,24199,8601,15598,Rural,Rural
54099,"Wayne, West Virginia",77.8,39385,13734,25651,Rural,Rural
54101,"Webster, West Virginia",14.6,8108,0,8108,Rural,Rural
54103,"Wetzel, West Virginia",42.0,15056,6978,8078,Rural,Rural
54105,"Wirt, West Virginia",25.1,5847,0,5847,Rural,Rural
54107,"Wood, West Virginia",228.0,83510,61142,22368,Urban,Rural
54109,"Wyoming, West Virginia",40.7,20323,2253,18070,Rural,Rural
55001,"Adams, Wisconsin",31.4,20295,0,20295,Rural,Rural
55003,"Ashland, Wisconsin",14.9,15570,7040,8530,Rural,Rural
55005,"Barron, Wisconsin",52.6,45356,15362,29994,Rural,Rural
55007,"Bayfield, Wisconsin",10.2,15102,0,15102,Rural,Rural
55009,"Brown, Wisconsin",500.7,265223,226490,38733,Urban,Urban
55011,"Buffalo, Wisconsin",19.4,13029,0,13029,Rural,Rural
55013,"Burnett, Wisconsin",18.8,15479,0,15479,Rural,Rural
55015,"Calumet, Wisconsin",157.7,50171,36356,13815,Urban,Rural
55017,"Chippewa, Wisconsin",64.3,64853,34933,29920,Urban,Rural
55019,"Clark, Wisconsin",28.8,34805,2877,31928,Rural,Rural
55021,"Columbia, Wisconsin",75.3,57659,22601,35058,Urban,Rural
55023,"Crawford, Wisconsin",28.3,16160,6108,10052,Rural,Rural
55025,"Dane, Wisconsin",458.1,548462,480598,67864,Urban,Rural
55027,"Dodge, Wisconsin",100.6,88047,45117,42930,Urban,Rural
55029,"Door, Wisconsin",57.7,27789,8657,19132,Rural,Rural
55031,"Douglas, Wisconsin",33.1,43204,26468,16736,Rural,Rural
55033,"Dunn, Wisconsin",53.5,45521,18296,27225,Rural,Rural
55035,"Eau Claire, Wisconsin",164.3,104836,80496,24340,Urban,Rural
55037,"Florence, Wisconsin",8.8,4319,0,4319,Rural,Rural
55039,"Fond Du Lac, Wisconsin",144.1,103698,67198,36500,Urban,Rural
55041,"Forest, Wisconsin",8.9,9011,0,9011,Rural,Rural
55043,"Grant, Wisconsin",44.9,51522,18677,32845,Urban,Rural
55045,"Green, Wisconsin",63.4,37039,14676,22363,Rural,Rural
55047,"Green Lake, Wisconsin",54.4,19009,4851,14158,Rural,Rural
55049,"Iowa, Wisconsin",31.1,23734,4744,18990,Rural,Rural
55051,"Iron, Wisconsin",7.5,5709,1823,3886,Rural,Rural
55053,"Jackson, Wisconsin",20.9,20678,5671,15007,Rural,Rural
55055,"Jefferson, Wisconsin",152.5,84882,55683,29199,Urban,Rural
55057,"Juneau, Wisconsin",34.9,26786,4440,22346,Rural,Rural
55059,"Kenosha, Wisconsin",625.0,170000,151746,18254,Urban,Urban
55061,"Kewaunee, Wisconsin",59.7,20462,5665,14797,Rural,Rural
55063,"La Crosse, Wisconsin",261.8,118274,98310,19964,Urban,Rural
55065,"Lafayette, Wisconsin",26.3,16671,0,16671,Rural,Rural
55067,"Langlade, Wisconsin",22.1,19245,7860,11385,Rural,Rural
55069,"Lincoln, Wisconsin",31.4,27628,12736,14892,Rural,Rural
55071,"Manitowoc, Wisconsin",134.3,79127,48335,30792,Urban,Rural
55073,"Marathon, Wisconsin",87.9,135735,78148,57587,Urban,Rural
55075,"Marinette, Wisconsin",28.9,40466,15349,25117,Rural,Rural
55077,"Marquette, Wisconsin",34.4,15654,0,15654,Rural,Rural
55078,"Menominee, Wisconsin",12.8,4573,0,4573,Rural,Rural
55079,"Milwaukee, Wisconsin",3911.5,944245,942421,1824,Urban,Urban
55081,"Monroe, Wisconsin",51.5,46373,19550,26823,Rural,Rural
55083,"Oconto, Wisconsin",38.2,38100,7079,31021,Rural,Rural
55085,"Oneida, Wisconsin",32.1,35754,8946,26808,Rural,Rural
55087,"Outagamie, Wisconsin",295.5,188401,141411,46990,Urban,Rural
55089,"Ozaukee, Wisconsin",384.1,89524,67227,22297,Urban,Rural
55091,"Pepin, Wisconsin",31.5,7309,0,7309,Rural,Rural
55093,"Pierce, Wisconsin",74.8,42935,19911,23024,Rural,Rural
55095,"Polk, Wisconsin",48.1,43940,6430,37510,Rural,Rural
55097,"Portage, Wisconsin",88.4,70776,45189,25587,Urban,Rural
55099,"Price, Wisconsin",10.7,13389,0,13389,Rural,Rural
55101,"Racine, Wisconsin",591.3,196612,172470,24142,Urban,Urban
55103,"Richland, Wisconsin",29.4,17240,4775,12465,Rural,Rural
55105,"Rock, Wisconsin",228.1,163774,130125,33649,Urban,Rural
55107,"Rusk, Wisconsin",15.6,14222,3313,10909,Rural,Rural
55109,"St Croix, Wisconsin",126.1,91057,42656,48401,Urban,Rural
55111,"Sauk, Wisconsin",77.8,64622,34716,29906,Urban,Rural
55113,"Sawyer, Wisconsin",13.2,16615,2640,13975,Rural,Rural
55115,"Shawano, Wisconsin",45.9,40974,10423,30551,Rural,Rural
55117,"Sheboygan, Wisconsin",226.2,115651,82988,32663,Urban,Rural
55119,"Taylor, Wisconsin",20.9,20373,4010,16363,Rural,Rural
55121,"Trempealeau, Wisconsin",40.5,29655,3074,26581,Rural,Rural
55123,"Vernon, Wisconsin",39.0,30885,4394,26491,Rural,Rural
55125,"Vilas, Wisconsin",26.1,22335,0,22335,Rural,Rural
55127,"Walworth, Wisconsin",187.9,104293,68795,35498,Urban,Rural
55129,"Washburn, Wisconsin",19.8,15790,2663,13127,Rural,Rural
55131,"Washington, Wisconsin",316.9,136505,94317,42188,Urban,Rural
55133,"Waukesha, Wisconsin",737.7,405395,365440,39955,Urban,Urban
55135,"Waupaca, Wisconsin",68.3,51100,17874,33226,Urban,Rural
55137,"Waushara, Wisconsin",39.2,24553,2553,22000,Rural,Rural
55139,"Winnebago, Wisconsin",396.7,172363,148936,23427,Urban,Rural
55141,"Wood, Wisconsin",92.1,73064,46305,26759,Urban,Rural
56001,"Albany, Wyoming",9.1,38807,34130,4677,Rural,Rural
56003,"Big Horn, Wyoming",3.8,11811,0,11811,Rural,Rural
56005,"Campbell, Wyoming",9.6,46121,32650,13471,Rural,Rural
56007,"Carbon, Wyoming",1.9,14741,8605,6136,Rural,Rural
56009,"Converse, Wyoming",3.2,13816,6146,7670,Rural,Rural
56011,"Crook, Wyoming",2.7,7602,0,7602,Rural,Rural
56013,"Fremont, Wyoming",4.3,39197,19052,20145,Rural,Rural
56015,"Goshen, Wyoming",5.9,13231,7172,6059,Rural,Rural
56017,"Hot Springs, Wyoming",2.2,4392,3009,1383,Rural,Rural
56019,"Johnson, Wyoming",2.0,8468,4326,4142,Rural,Rural
56021,"Laramie, Wyoming",37.2,99801,79932,19869,Urban,Rural
56023,"Lincoln, Wyoming",4.9,19914,3354,16560,Rural,Rural
56025,"Natrona, Wyoming",14.9,79808,68261,11547,Urban,Rural
56027,"Niobrara, Wyoming",0.9,2344,0,2344,Rural,Rural
56029,"Park, Wyoming",4.2,29348,16099,13249,Rural,Rural
56031,"Platte, Wyoming",4.0,8409,3444,4965,Rural,Rural
56033,"Sheridan, Wyoming",12.1,30632,19726,10906,Rural,Rural
56035,"Sublette, Wyoming",2.0,9845,0,9845,Rural,Rural
56037,"Sweetwater, Wyoming",4.0,42226,37591,4635,Rural,Rural
56039,"Teton, Wyoming",5.9,23376,12480,10896,Rural,Rural
56041,"Uinta, Wyoming",9.7,20194,11466,8728,Rural,Rural
56043,"Washakie, Wyoming",3.5,7793,4935,2858,Rural,Rural
56045,"Weston, Wyoming",2.9,6916,3138,3778,Rural,Rural
